userid,age,dob_day,dob_year,dob_month,gender,tenure,friend_count,friendships_initiated,likes,likes_received,mobile_likes,mobile_likes_received,www_likes,www_likes_received
2150249,29,20,1984,3,male,837,48,23,22,7,22,5,0,2
1191847,21,1,1992,2,male,1524,48,36,23,3,0,2,23,1
1047270,23,19,1990,3,male,110,49,41,23,0,10,0,13,0
1790977,25,1,1988,11,male,164,48,31,23,1,23,1,0,0
1364156,58,21,1955,2,male,437,48,32,23,12,23,11,0,1
1632937,32,9,1981,6,female,399,48,20,23,36,23,35,0,1
1041981,25,2,1988,1,male,501,48,21,23,64,23,40,0,24
1924720,45,15,1968,12,female,901,49,41,24,3,3,1,21,2
2013019,76,17,1937,12,female,348,48,30,24,32,0,10,24,22
1375741,22,20,1991,5,male,312,48,8,24,48,22,32,2,16
1063479,53,26,1960,8,male,231,49,31,24,0,24,0,0,0
1236913,28,17,1985,12,male,262,49,44,24,1,24,1,0,0
1807873,20,11,1993,4,male,424,48,26,24,8,24,8,0,0
1172468,64,24,1949,3,female,392,49,20,24,20,24,8,0,12
1131516,69,31,1944,7,male,220,49,28,24,22,24,12,0,10
1519499,21,22,1992,12,male,494,48,23,24,72,24,43,0,29
1548966,29,14,1984,1,female,194,48,24,25,29,3,5,22,24
1755567,62,23,1951,9,male,409,48,32,25,22,0,6,25,16
1081788,21,7,1992,6,female,50,48,32,25,103,0,53,25,50
1114424,73,25,1940,1,male,205,48,27,25,2,25,1,0,1
1340901,53,5,1960,5,female,329,48,42,25,9,25,9,0,0
1981387,18,8,1995,11,female,417,49,17,25,10,25,8,0,2
1329261,25,4,1988,6,male,529,48,31,25,6,25,3,0,3
1392048,56,1,1957,4,male,261,48,28,25,20,25,20,0,0
1754224,30,6,1983,7,male,157,49,32,25,38,25,14,0,24
1926956,19,13,1994,1,male,160,48,43,26,22,14,18,12,4
1453171,32,14,1981,3,male,92,49,34,26,8,20,4,6,4
1250933,39,1,1974,8,male,400,48,38,26,33,20,12,6,21
1097195,47,12,1966,1,female,289,48,19,26,15,26,13,0,2
1542974,24,19,1989,8,male,130,49,38,26,18,26,18,0,0
1154718,46,26,1967,10,male,347,49,28,26,62,26,34,0,28
1915219,99,8,1914,10,male,513,48,38,27,4,27,2,0,2
1855163,68,1,1945,11,male,678,49,36,27,1,27,1,0,0
1731463,34,29,1979,3,male,1546,48,13,28,10,24,10,4,0
1344895,27,8,1986,5,male,1818,48,38,28,23,26,22,2,1
2033411,47,1,1966,4,male,224,49,22,28,11,28,8,0,3
1725357,51,16,1962,6,female,153,49,25,28,44,28,12,0,32
1835705,38,14,1975,2,female,522,49,29,29,26,18,7,11,19
1328293,29,31,1984,3,female,233,48,21,29,17,29,11,0,6
1749763,108,19,1905,6,male,203,48,27,29,30,29,20,0,10
1736139,70,7,1943,10,female,269,49,39,29,19,29,11,0,8
1173536,25,12,1988,8,male,213,48,18,29,138,29,131,0,7
2072284,15,22,1998,5,male,410,49,40,31,5,0,0,31,5
1965124,24,4,1989,12,male,944,48,32,31,2,0,1,31,1
2061095,23,7,1990,4,female,611,49,36,31,63,0,29,31,34
1086780,43,6,1970,1,female,1721,49,29,31,60,17,44,14,16
1819106,55,1,1958,2,male,279,48,15,31,148,28,103,3,45
1374184,65,8,1948,4,male,195,49,46,30,238,30,225,0,13
1198565,64,9,1949,2,female,253,48,35,32,5,0,2,32,3
1361122,41,31,1972,2,male,203,48,39,32,3,2,0,30,3
1201673,26,25,1987,7,male,76,49,46,32,13,32,9,0,4
1587869,37,1,1976,10,male,834,49,27,32,17,32,16,0,1
1022194,87,23,1926,3,male,219,48,15,32,49,32,40,0,9
1028897,15,8,1998,1,female,482,49,13,33,4,0,0,33,4
1766058,51,2,1962,7,female,1147,49,31,33,18,0,6,33,12
1303625,57,25,1956,3,female,524,49,17,33,29,21,15,12,14
1257750,31,27,1982,11,female,331,48,26,33,2,31,2,2,0
1414063,88,14,1925,3,male,258,48,13,33,0,33,0,0,0
1114884,57,4,1956,11,female,407,48,29,33,14,33,9,0,5
1697656,48,21,1965,7,female,116,48,45,33,43,33,33,0,10
1303460,63,10,1950,3,male,705,48,28,33,38,33,34,0,4
1632839,24,29,1989,12,male,543,48,33,34,21,0,6,34,15
1235028,65,17,1948,8,female,290,48,39,34,57,14,8,20,49
1428052,108,1,1905,10,female,590,49,21,34,57,26,51,8,6
2176817,17,13,1996,2,male,222,48,23,34,17,34,8,0,9
1085272,33,13,1980,5,male,312,48,18,34,50,34,23,0,27
1798067,66,28,1947,10,female,176,49,27,36,44,0,15,36,29
1679866,18,19,1995,5,female,1806,49,20,36,0,23,0,13,0
1527267,33,23,1980,8,female,1783,48,16,36,6,19,4,17,2
1208063,51,19,1962,12,male,325,48,44,36,4,36,4,0,0
1463057,50,7,1963,7,male,189,49,42,35,21,35,20,0,1
1640959,70,7,1943,4,female,776,49,27,36,43,36,26,0,17
1380683,49,12,1964,3,male,570,48,40,36,145,36,143,0,2
1247997,66,16,1947,11,female,446,48,22,36,55,36,53,0,2
1530105,47,3,1966,1,female,1017,49,21,37,49,6,16,31,33
2170317,14,29,1999,10,female,1428,48,15,37,55,18,25,19,30
1251183,35,30,1978,10,female,358,49,32,37,20,37,7,0,13
2122129,62,1,1951,5,male,109,48,32,37,10,37,6,0,4
1580415,20,30,1993,2,male,392,49,32,38,3,5,1,33,2
1767975,25,13,1988,8,male,1446,49,25,39,49,0,24,39,25
1238388,26,2,1987,4,male,478,49,28,39,4,11,2,28,2
1011033,24,18,1989,1,male,88,48,45,38,12,31,7,7,5
2185025,18,8,1995,7,female,136,48,27,38,73,28,51,10,22
1973633,57,15,1956,1,female,306,48,15,39,8,39,8,0,0
1575898,14,15,1999,1,male,209,49,41,39,19,39,19,0,0
1946865,15,20,1998,8,female,266,48,23,39,17,39,17,0,0
1508930,25,18,1988,5,male,145,48,39,40,21,25,7,15,14
1781674,30,1,1983,3,female,728,48,20,40,35,40,10,0,25
1389001,40,25,1973,7,female,380,49,23,42,6,0,1,42,5
1730062,47,4,1966,2,male,604,49,46,42,1,17,1,25,0
1140701,29,13,1984,1,female,709,49,28,42,103,26,59,16,44
1917395,59,11,1954,9,male,365,48,36,44,8,37,8,7,0
1680474,68,27,1945,3,male,202,48,33,44,35,41,21,3,14
1365783,30,29,1983,6,female,204,48,28,43,65,32,50,11,15
2192349,52,13,1961,9,female,157,49,36,44,6,44,6,0,0
1064365,59,30,1954,5,female,440,49,40,44,10,44,8,0,2
1076021,104,17,1909,8,male,137,48,20,43,49,43,35,0,14
1617942,18,7,1995,1,male,620,48,35,43,39,43,32,0,7
1495489,17,28,1996,9,female,73,48,16,43,117,43,86,0,31
1769700,94,28,1919,12,male,1539,49,18,45,56,43,39,2,17
1072816,36,26,1977,3,male,194,48,39,45,6,45,5,0,1
1972464,37,10,1976,5,female,292,48,22,45,21,45,13,0,8
1693009,37,6,1976,6,female,374,49,33,45,24,45,15,0,9
1018512,21,7,1992,9,female,303,48,27,47,22,0,19,47,3
1142429,34,26,1979,11,male,344,48,24,46,2,46,2,0,0
1214932,22,5,1991,10,male,27,48,34,46,12,46,11,0,1
1269393,40,31,1973,4,female,266,49,28,47,52,47,45,0,7
2154572,32,19,1981,8,male,994,49,17,49,560,0,83,49,477
1957200,20,4,1993,7,female,1836,48,2,48,26,47,16,1,10
1276284,29,1,1984,5,female,41,49,32,49,60,39,51,10,9
1177572,32,20,1981,8,male,608,48,41,48,5,48,3,0,2
1267974,24,21,1989,1,male,431,49,30,48,9,48,8,0,1
1268466,32,25,1981,2,female,411,49,38,51,7,51,6,0,1
2154571,76,18,1937,2,male,230,49,39,50,4,50,3,0,1
1752362,25,2,1988,5,female,184,49,34,51,1,51,1,0,0
2111662,30,15,1983,4,female,309,48,41,51,1,51,1,0,0
1918355,35,11,1978,12,female,912,48,17,50,14,50,13,0,1
1755775,98,18,1915,10,male,598,49,43,51,76,51,73,0,3
2002007,22,12,1991,2,female,356,49,32,50,35,50,24,0,11
1061488,30,26,1983,5,male,827,49,39,51,47,51,44,0,3
1811520,23,5,1990,5,female,747,48,33,53,6,0,3,53,3
1455117,13,2,2000,7,male,677,49,39,52,18,36,11,16,7
1956871,15,18,1998,10,male,408,48,37,52,5,52,1,0,4
1651593,25,1,1988,4,male,501,49,23,52,53,52,34,0,19
1149738,18,19,1995,1,NA,1724,48,29,54,33,5,27,49,6
1188112,47,29,1966,5,male,603,48,20,55,24,21,19,34,5
1637311,20,15,1993,1,female,442,49,24,54,48,54,46,0,2
1259196,35,10,1978,5,male,418,48,29,57,12,1,2,56,10
1698699,39,7,1974,4,female,1480,48,27,57,62,49,42,8,20
1884678,47,10,1966,6,male,1266,48,24,56,0,56,0,0,0
1658453,24,1,1989,4,male,143,48,39,58,7,58,7,0,0
1008904,35,12,1978,11,female,415,49,39,58,22,58,15,0,7
1255323,38,15,1975,11,male,277,49,32,60,21,0,10,60,11
1536792,22,15,1991,10,female,561,48,42,60,13,1,6,59,7
1866427,17,28,1996,2,male,1825,49,36,59,107,39,64,20,43
1833614,25,20,1988,2,female,859,49,9,59,8,58,6,1,2
1477142,39,11,1974,3,male,365,49,21,60,2,60,1,0,1
2084154,18,13,1995,1,male,261,48,34,59,51,59,46,0,5
1094656,56,5,1957,8,female,873,48,24,59,62,59,58,0,4
1328830,32,14,1981,2,female,430,49,37,62,9,0,5,62,4
1815509,61,21,1952,10,male,742,49,13,61,4,0,2,61,2
1940315,19,17,1994,7,female,2170,48,13,63,30,0,6,63,24
1203989,33,11,1980,11,male,498,48,21,61,15,60,12,1,3
1922014,47,1,1966,8,female,780,49,41,63,6,63,4,0,2
1901199,49,14,1964,1,female,598,48,26,62,4,62,2,0,2
1376840,21,15,1992,11,female,362,48,28,63,55,63,55,0,0
2161011,69,24,1944,6,male,153,49,33,61,47,61,45,0,2
1159280,31,28,1982,7,female,503,49,31,61,41,61,16,0,25
1915462,49,27,1964,12,male,409,48,28,64,24,34,8,30,16
1765868,113,8,1900,4,male,1388,49,32,65,81,61,32,4,49
2015936,36,31,1977,5,male,1460,49,24,65,8,65,2,0,6
1466937,52,29,1961,8,female,505,48,15,65,60,65,51,0,9
1132404,15,21,1998,4,female,523,49,35,66,27,0,19,66,8
1043648,51,21,1962,6,male,505,49,36,68,91,0,17,68,74
1610752,33,7,1980,2,female,454,49,31,66,17,47,16,19,1
1177068,68,8,1945,2,female,371,48,24,66,40,59,17,7,23
1557419,25,10,1988,9,male,1476,48,23,66,15,57,11,9,4
1787725,49,24,1964,1,male,297,48,35,67,32,67,30,0,2
1317474,35,31,1978,3,male,107,48,28,67,33,67,21,0,12
1540227,15,19,1998,4,male,1094,49,36,71,57,0,3,71,54
1205793,30,30,1983,9,female,530,49,18,69,10,16,5,53,5
1570850,50,19,1963,5,male,381,48,44,69,8,56,2,13,6
1966380,68,5,1945,6,female,397,49,34,69,25,69,7,0,18
2189378,68,3,1945,3,male,285,48,33,70,53,70,51,0,2
1195648,18,21,1995,11,male,400,48,34,74,3,0,2,74,1
1351799,22,7,1991,6,male,234,48,38,72,33,0,13,72,20
1049407,61,30,1952,12,female,290,49,29,73,20,12,7,61,13
1403868,16,2,1997,11,male,159,49,29,72,126,0,52,72,74
1207216,29,1,1984,5,female,276,48,34,73,10,70,4,3,6
1026687,38,31,1975,10,male,134,49,42,73,5,73,4,0,1
1877998,55,28,1958,9,female,504,48,31,73,22,73,17,0,5
1460026,22,16,1991,5,female,100,48,36,74,45,74,32,0,13
1116556,25,3,1988,12,female,677,49,38,74,16,74,13,0,3
1154674,54,4,1959,4,male,349,48,42,74,51,74,42,0,9
1549456,51,16,1962,10,female,440,49,26,75,24,1,9,74,15
2049850,57,7,1956,11,female,116,49,31,77,91,68,35,9,56
1855722,17,22,1996,3,female,732,49,31,77,35,77,34,0,1
1324249,24,23,1989,4,female,915,48,38,75,25,75,6,0,19
1442771,21,1,1992,8,female,352,48,26,77,132,77,42,0,90
1086430,28,1,1985,12,female,1646,49,33,79,6,29,5,50,1
1838873,59,13,1954,7,female,443,49,42,78,104,77,87,1,17
2023727,14,5,1999,7,female,488,48,26,79,10,79,8,0,2
1275473,72,5,1941,10,male,468,49,25,79,250,79,84,0,166
2072450,35,15,1978,12,female,513,49,25,81,8,43,4,38,4
1337412,101,29,1912,8,male,306,49,17,84,1,83,1,1,0
1323401,46,2,1967,6,male,369,49,34,82,60,80,36,2,24
1843935,37,20,1976,10,female,381,48,31,84,91,65,86,19,5
2094311,28,5,1985,4,male,156,49,11,81,35,81,30,0,5
1158530,37,3,1976,1,female,54,49,28,81,15,81,7,0,8
1813029,52,20,1961,2,female,438,48,30,81,28,81,11,0,17
1977676,33,13,1980,5,female,1151,49,20,84,32,84,19,0,13
1665805,21,30,1992,3,male,15,48,30,81,58,81,58,0,0
2048603,33,3,1980,1,female,11,48,31,84,138,84,128,0,10
1731582,24,1,1989,12,female,496,48,11,84,353,84,293,0,60
1691699,41,16,1972,10,female,1263,49,30,85,18,0,3,85,15
1462347,24,17,1989,2,male,603,48,32,85,60,81,44,4,16
1755155,23,9,1990,2,male,519,48,11,86,38,86,22,0,16
1903669,62,16,1951,12,female,508,49,21,86,50,86,43,0,7
2160439,80,25,1933,4,female,1235,48,28,90,5,70,4,20,1
2008062,18,1,1995,7,male,495,49,49,88,42,87,32,1,10
1399176,25,20,1988,10,male,1630,49,25,88,121,74,92,14,29
1775360,33,25,1980,7,female,488,48,33,91,54,91,41,0,13
1720697,70,31,1943,6,female,515,49,14,91,34,91,24,0,10
1194324,71,28,1942,4,female,363,49,38,92,32,5,15,87,17
1941814,18,25,1995,6,female,1655,48,28,92,278,0,13,92,265
2084269,43,8,1970,3,female,108,49,16,95,3,95,3,0,0
1080158,21,7,1992,8,female,247,48,36,96,64,90,33,6,31
1684572,30,19,1983,12,male,365,49,28,99,10,99,6,0,4
1382296,32,23,1981,6,female,1355,49,26,96,32,96,25,0,7
1668150,51,20,1962,8,male,1360,49,15,97,69,97,42,0,27
1467587,75,19,1938,11,female,501,48,42,100,88,0,23,100,65
2153970,30,27,1983,4,male,251,49,37,104,14,104,7,0,7
1304638,31,6,1982,5,female,134,48,28,106,32,1,17,105,15
1985106,56,2,1957,10,female,438,48,18,109,66,0,25,109,41
1614233,66,18,1947,3,female,661,49,20,105,30,0,16,105,14
1522538,59,11,1954,6,male,2058,48,33,109,102,64,63,45,39
1287224,20,10,1993,5,male,2173,49,21,108,158,53,76,55,82
1414622,25,9,1988,4,female,1732,49,34,106,32,81,14,25,18
1859174,50,15,1963,8,male,327,49,38,108,2,108,2,0,0
1112528,108,1,1905,10,male,283,48,26,110,52,0,15,110,37
1438802,37,13,1976,1,female,776,49,14,110,14,110,13,0,1
2108855,22,10,1991,1,male,164,48,31,113,65,113,49,0,16
1529700,45,18,1968,12,male,495,48,38,119,56,84,42,35,14
1277855,66,16,1947,9,female,48,49,39,116,70,114,67,2,3
2029196,27,8,1986,11,male,663,48,37,116,293,110,276,6,17
1240314,52,19,1961,1,female,305,48,36,117,13,117,3,0,10
1663969,22,29,1991,6,female,241,49,26,114,34,114,28,0,6
1065891,33,5,1980,1,female,1645,49,27,120,18,16,5,104,13
1125187,50,1,1963,10,female,676,48,24,122,125,0,93,122,32
1990345,52,9,1961,2,female,1187,48,22,126,68,0,10,126,58
1519108,30,15,1983,10,female,2115,48,13,128,29,0,21,128,8
2084179,47,8,1966,3,female,67,48,40,129,195,51,59,78,136
1673035,18,1,1995,8,female,351,49,26,125,38,125,30,0,8
1605616,50,10,1963,9,female,51,48,38,126,60,126,60,0,0
1551792,57,25,1956,8,female,555,48,8,128,130,128,103,0,27
1304020,73,9,1940,6,male,282,49,37,135,1,0,0,135,1
1729064,82,15,1931,8,female,1787,48,26,135,50,135,17,0,33
1490455,15,3,1998,10,female,388,49,37,141,15,0,1,141,14
2094561,58,1,1955,11,male,196,48,24,137,63,0,29,137,34
1323763,67,25,1946,1,female,445,48,30,140,31,48,14,92,17
1679083,26,12,1987,9,female,299,48,38,143,89,34,24,109,65
1017691,27,6,1986,8,male,393,49,33,142,147,128,63,14,84
1305241,50,9,1963,12,male,169,48,37,140,12,140,3,0,9
1200948,20,26,1993,1,male,188,48,44,137,31,137,22,0,9
1363502,53,4,1960,11,male,66,49,32,142,152,142,152,0,0
1294224,58,15,1955,9,female,377,49,39,145,2,145,1,0,1
1188980,23,2,1990,11,female,1382,48,17,149,193,149,134,0,59
1721142,67,26,1946,3,male,417,48,42,151,56,28,19,123,37
1380709,58,10,1955,7,female,340,49,23,157,15,156,10,1,5
1441149,41,7,1972,10,female,136,48,33,161,145,0,100,161,45
2008959,46,28,1967,1,female,338,49,27,164,200,0,84,164,116
1789198,64,6,1949,8,male,429,49,33,162,54,85,42,77,12
1512234,19,13,1994,4,male,320,48,29,164,63,159,24,5,39
1014931,100,21,1913,3,male,301,48,30,164,85,121,57,43,28
2057191,65,26,1948,10,female,653,49,15,164,165,149,28,15,137
2174277,59,26,1954,1,male,2054,48,10,164,28,164,20,0,8
1976820,25,25,1988,6,female,514,49,29,161,233,161,109,0,124
1055615,56,1,1957,2,female,253,49,36,159,313,159,269,0,44
2175164,28,18,1985,12,female,672,49,30,167,0,167,0,0,0
2016157,46,9,1967,2,female,74,49,36,168,24,168,23,0,1
1913649,22,11,1991,1,male,81,49,42,168,55,168,41,0,14
1545536,51,27,1962,7,female,214,48,40,165,126,165,80,0,46
1815136,54,24,1959,2,female,454,49,28,166,250,166,250,0,0
1818686,44,23,1969,9,female,226,48,21,177,206,37,74,140,132
1721203,31,3,1982,10,female,384,49,15,177,180,173,142,4,38
1520623,23,12,1990,12,female,307,49,29,174,394,159,141,15,253
1008709,57,8,1956,4,male,368,49,35,179,6,179,4,0,2
1284983,67,19,1946,1,female,2284,49,24,174,76,174,35,0,41
1268773,22,15,1991,3,female,276,49,36,177,88,177,66,0,22
1748670,23,10,1990,7,female,133,49,28,184,106,0,72,184,34
1523538,35,3,1978,9,male,325,48,27,184,121,0,10,184,111
1398882,32,6,1981,2,female,119,48,17,185,74,75,23,110,51
1629778,56,25,1957,4,male,262,49,35,185,1,169,1,16,0
1410351,46,16,1967,2,female,475,48,41,184,74,168,48,16,26
1752321,69,3,1944,6,female,128,49,20,188,145,188,145,0,0
1742391,23,29,1990,8,female,201,48,23,186,149,186,65,0,84
1640076,55,30,1958,7,female,493,49,28,196,32,0,26,196,6
1258790,16,7,1997,5,male,996,49,27,195,5,106,4,89,1
1136942,56,25,1957,8,female,787,48,13,207,195,29,143,178,52
1271654,16,19,1997,3,female,215,49,32,211,183,0,31,211,152
2041181,34,2,1979,4,female,311,48,19,207,7,207,1,0,6
1441912,34,20,1979,10,male,1342,49,26,206,142,206,93,0,49
1731703,20,16,1993,7,female,511,49,28,216,14,0,3,216,11
1570860,33,1,1980,8,female,282,49,31,219,54,219,32,0,22
1600394,58,19,1955,3,female,70,49,41,218,154,218,102,0,52
1827357,73,30,1940,10,female,299,48,31,226,209,221,120,5,89
2156080,13,28,2000,10,female,2248,48,22,229,226,216,198,13,28
1452704,25,1,1988,1,female,462,48,16,228,57,228,44,0,13
1819383,36,21,1977,4,female,200,48,33,230,272,230,229,0,43
1222254,77,30,1936,1,male,740,48,44,246,19,4,5,242,14
1607321,35,26,1978,4,female,203,49,16,239,473,210,87,29,386
1638221,38,23,1975,1,female,560,49,30,234,87,234,69,0,18
1766876,44,12,1969,2,female,149,48,36,239,184,239,165,0,19
1622095,57,1,1956,7,male,791,48,32,248,273,149,181,99,92
1071019,19,5,1994,10,female,2261,49,14,250,160,112,41,138,119
1965449,48,16,1965,6,female,627,48,23,256,136,192,50,64,86
1538839,31,22,1982,1,male,222,49,22,253,144,253,124,0,20
1743893,50,9,1963,5,female,307,49,46,255,45,255,44,0,1
1607910,18,1,1995,8,female,836,49,19,259,182,259,56,0,126
1252404,74,25,1939,12,female,593,49,35,268,58,211,23,57,35
1059616,17,10,1996,10,female,347,49,29,268,224,247,131,21,93
1426745,28,14,1985,6,male,1273,49,27,270,22,270,19,0,3
2145476,30,11,1983,3,male,39,49,44,267,144,267,142,0,2
1680417,67,9,1946,10,female,428,49,31,285,117,250,82,35,35
1210337,71,14,1942,4,female,143,49,37,300,20,0,2,300,18
1907062,61,3,1952,12,male,475,49,34,299,93,0,66,299,27
1402163,50,7,1963,10,female,1165,48,23,297,260,279,158,18,102
1511892,45,23,1968,7,female,1271,49,18,304,22,304,7,0,15
1386015,56,25,1957,4,female,739,48,16,296,153,296,35,0,118
1229515,68,28,1945,8,female,731,49,13,310,116,0,22,310,94
1094917,46,15,1967,6,female,807,48,26,315,67,0,15,315,52
2111470,67,5,1946,11,male,43,49,48,312,15,312,14,0,1
1772765,44,8,1969,1,female,1310,48,18,328,30,0,2,328,28
1303356,19,24,1994,9,male,1136,48,15,343,22,197,12,146,10
1197511,58,7,1955,10,female,173,48,33,336,193,94,96,242,97
1822709,59,1,1954,4,female,300,48,29,338,38,338,27,0,11
1880066,44,16,1969,2,female,594,48,30,367,156,211,127,156,29
1286068,57,2,1956,8,female,490,49,35,375,22,0,5,375,17
2049600,51,16,1962,12,female,227,48,36,385,22,385,15,0,7
1397953,44,20,1969,4,female,348,49,42,386,222,386,104,0,118
1421836,19,15,1994,7,female,1294,48,6,394,155,394,71,0,84
1048393,36,28,1977,12,male,168,49,31,398,109,306,50,92,59
1030294,54,4,1959,12,male,17,49,46,413,195,413,189,0,6
1663956,66,24,1947,1,male,904,48,29,443,46,443,37,0,9
1357624,57,5,1956,5,male,162,48,24,436,80,436,64,0,16
1038579,77,24,1936,10,female,51,49,32,426,136,426,121,0,15
1442550,28,22,1985,9,female,199,48,33,437,219,437,179,0,40
1945087,33,22,1980,2,male,128,48,42,478,64,339,7,139,57
2008774,33,24,1980,8,female,1603,48,22,469,162,258,95,211,67
1377781,100,28,1913,7,female,605,48,31,481,1170,258,419,223,751
1995136,44,1,1969,9,female,695,48,41,467,61,459,50,8,11
1602292,32,15,1981,9,female,649,48,28,464,242,463,146,1,96
1950362,28,10,1985,10,female,1126,48,29,510,271,510,211,0,60
2087995,63,20,1950,6,female,431,49,28,528,87,0,25,528,62
2078767,73,1,1940,1,female,282,49,41,558,153,558,131,0,22
1872605,38,10,1975,1,female,727,49,34,578,174,0,21,578,153
1195479,61,29,1952,11,female,725,49,22,584,167,580,93,4,74
1668590,15,4,1998,12,male,191,49,22,564,57,564,30,0,27
1615609,27,8,1986,12,female,292,49,36,582,151,582,100,0,51
1217775,19,27,1994,5,female,658,49,35,638,74,0,33,638,41
1154673,65,11,1948,9,female,198,48,25,650,579,650,520,0,59
1031847,58,2,1955,8,female,850,48,33,725,913,712,489,13,424
1459008,23,31,1990,10,female,525,49,30,690,40,690,19,0,21
1406322,46,21,1967,12,female,92,49,31,756,110,756,43,0,67
1703323,51,24,1962,4,male,229,48,15,839,47,0,39,839,8
2167615,56,8,1957,8,female,269,48,33,883,453,75,169,808,284
1718488,57,18,1956,11,male,739,48,24,966,792,641,107,325,685
1278790,17,10,1996,6,female,113,48,36,980,222,859,137,121,85
1529329,53,1,1960,11,female,662,49,35,914,297,914,157,0,140
1629218,46,27,1967,7,female,205,48,31,1130,1235,1114,488,16,747
1893231,98,3,1915,10,female,572,49,24,1121,274,1121,199,0,75
1566956,15,15,1998,11,female,1046,49,26,1144,303,0,38,1144,265
1656270,20,25,1993,10,female,1599,48,27,1168,32,387,18,781,14
1115371,23,27,1990,2,male,536,48,25,1148,54,305,27,843,27
1593042,46,11,1967,1,male,140,49,45,1637,159,0,62,1637,97
1922423,20,22,1993,11,female,1265,49,13,1816,181,1035,65,781,116
1591520,22,12,1991,11,male,154,49,40,2127,90,2127,55,0,35
2158968,34,27,1979,5,female,402,49,36,1961,441,1961,216,0,225
1731340,25,14,1988,11,female,1641,49,27,3109,44,3109,38,0,6
1172980,17,10,1996,5,female,297,48,15,2562,3949,2562,2960,0,989
1879306,22,20,1991,2,male,181,50,35,0,0,0,0,0,0
2048557,29,7,1984,11,male,318,51,20,0,0,0,0,0,0
1516679,64,26,1949,1,male,563,51,35,0,1,0,1,0,0
2045898,65,9,1948,2,male,625,50,16,0,0,0,0,0,0
1939888,51,8,1962,3,male,22,51,47,0,10,0,7,0,3
1857063,53,13,1960,5,male,122,51,39,0,0,0,0,0,0
1419305,19,6,1994,6,male,155,51,47,0,14,0,2,0,12
2080830,36,2,1977,6,female,17,50,49,0,2,0,1,0,1
1147880,36,4,1977,12,male,357,50,31,0,0,0,0,0,0
1617709,22,19,1991,1,male,68,50,28,0,4,0,0,0,4
1640862,30,1,1983,2,male,214,51,29,0,2,0,1,0,1
2178900,55,13,1958,2,male,67,50,47,0,0,0,0,0,0
1955425,68,2,1945,6,male,231,50,38,0,0,0,0,0,0
1582057,61,12,1952,7,male,527,50,29,0,0,0,0,0,0
1481459,66,17,1947,7,male,167,51,50,0,0,0,0,0,0
1599975,69,27,1944,8,male,355,51,33,0,0,0,0,0,0
1030868,108,30,1905,10,male,25,50,50,0,0,0,0,0,0
1554238,51,3,1962,12,male,541,50,44,0,0,0,0,0,0
1121890,31,9,1982,1,male,725,50,38,0,1,0,0,0,1
1371196,39,9,1974,1,male,536,50,28,0,0,0,0,0,0
1375468,29,26,1984,2,male,614,51,33,0,1,0,0,0,1
1017440,67,16,1946,7,male,365,50,26,0,0,0,0,0,0
1383606,48,21,1965,5,female,46,51,47,0,8,0,2,0,6
1953670,56,29,1957,6,male,602,50,28,0,0,0,0,0,0
1629035,60,13,1953,7,male,447,51,42,0,5,0,1,0,4
1638366,59,21,1954,7,male,273,50,41,0,0,0,0,0,0
1149554,31,27,1982,7,male,132,51,46,0,1,0,1,0,0
1924665,47,15,1966,9,male,254,51,21,0,0,0,0,0,0
1678087,22,1,1991,10,male,505,50,25,0,6,0,5,0,1
1135014,102,15,1911,10,male,321,51,16,0,0,0,0,0,0
1853342,61,29,1952,1,male,64,50,49,0,0,0,0,0,0
1033902,20,1,1993,2,female,592,51,27,0,0,0,0,0,0
2016352,54,6,1959,2,male,480,51,37,0,0,0,0,0,0
2055323,22,5,1991,4,male,437,50,25,0,1,0,1,0,0
1423373,36,19,1977,4,female,358,50,43,0,0,0,0,0,0
1668798,34,16,1979,4,male,207,50,14,0,3,0,1,0,2
1904174,49,7,1964,4,male,31,51,29,0,2,0,0,0,2
1512154,24,25,1989,5,female,487,51,25,0,0,0,0,0,0
1974773,26,18,1987,6,male,328,50,28,0,0,0,0,0,0
1067791,56,28,1957,7,male,129,50,42,0,0,0,0,0,0
1055094,70,31,1943,9,male,143,51,37,0,4,0,4,0,0
1926464,65,19,1948,10,female,618,50,20,0,5,0,1,0,4
1304437,77,24,1936,11,male,445,50,19,0,0,0,0,0,0
1398460,31,15,1982,12,male,911,50,42,0,0,0,0,0,0
1732590,37,2,1976,12,female,624,50,35,0,0,0,0,0,0
1799329,51,4,1962,1,female,427,50,28,0,0,0,0,0,0
1933066,30,12,1983,1,male,340,50,34,0,0,0,0,0,0
1370294,66,26,1947,6,male,139,50,36,0,0,0,0,0,0
1666859,62,24,1951,7,male,317,51,25,0,4,0,0,0,4
1129329,20,3,1993,7,male,73,51,40,0,0,0,0,0,0
1754438,55,19,1958,8,male,62,50,44,0,0,0,0,0,0
1701043,52,16,1961,1,female,422,50,36,0,1,0,1,0,0
1337269,62,30,1951,3,male,88,50,33,0,0,0,0,0,0
2164932,53,5,1960,4,female,409,51,34,0,0,0,0,0,0
1329895,28,4,1985,4,male,334,51,27,0,4,0,0,0,4
1979074,66,10,1947,6,male,135,50,17,0,0,0,0,0,0
1034159,27,5,1986,7,male,349,50,30,0,0,0,0,0,0
1285829,23,10,1990,11,male,199,51,41,0,0,0,0,0,0
1290756,64,10,1949,12,male,295,51,35,0,0,0,0,0,0
1619824,20,6,1993,12,male,177,50,30,0,0,0,0,0,0
1113431,27,4,1986,1,male,5,50,41,0,43,0,21,0,22
2178404,56,2,1957,1,male,321,51,49,0,0,0,0,0,0
1275078,65,11,1948,1,male,266,51,14,0,0,0,0,0,0
1183592,51,2,1962,3,male,351,51,21,0,2,0,0,0,2
1509563,20,8,1993,5,male,144,51,41,0,1,0,1,0,0
1541888,31,18,1982,6,male,418,50,39,0,0,0,0,0,0
1875795,26,14,1987,9,female,631,51,25,0,1,0,1,0,0
2112254,59,21,1954,9,male,382,51,35,0,0,0,0,0,0
1991564,65,15,1948,11,male,200,50,32,0,0,0,0,0,0
1557449,38,10,1975,5,male,497,51,33,0,0,0,0,0,0
1976189,52,2,1961,6,female,660,51,33,0,0,0,0,0,0
1752345,53,1,1960,7,male,543,50,26,0,0,0,0,0,0
1667036,28,23,1985,12,female,185,50,27,0,5,0,2,0,3
1079236,56,22,1957,1,male,320,51,31,0,0,0,0,0,0
2190007,79,7,1934,2,female,432,50,36,0,4,0,0,0,4
1651212,36,1,1977,6,male,569,50,40,0,0,0,0,0,0
2077636,18,23,1995,6,female,421,51,43,0,0,0,0,0,0
1039889,25,4,1988,6,male,318,51,19,0,42,0,16,0,26
2108134,58,14,1955,7,male,47,51,50,0,3,0,1,0,2
1841480,95,19,1918,1,male,226,51,40,0,0,0,0,0,0
1180755,20,23,1993,3,male,381,51,44,0,0,0,0,0,0
1476685,54,11,1959,4,male,348,50,35,0,26,0,22,0,4
1770474,36,11,1977,7,male,409,51,40,0,2,0,1,0,1
2148981,48,24,1965,9,male,568,50,24,0,0,0,0,0,0
1931528,25,1,1988,10,female,476,50,1,0,0,0,0,0,0
1596232,23,24,1990,11,female,614,51,45,0,1,0,1,0,0
1187221,61,1,1952,12,male,190,51,50,0,0,0,0,0,0
1453829,68,31,1945,1,male,148,51,40,0,0,0,0,0,0
1246880,73,18,1940,2,male,174,51,28,0,12,0,8,0,4
2017974,58,9,1955,2,male,15,51,45,0,0,0,0,0,0
1272974,20,27,1993,3,male,447,51,2,0,0,0,0,0,0
2062977,62,24,1951,3,male,430,51,48,0,2,0,0,0,2
2021060,47,25,1966,3,male,27,51,48,0,41,0,38,0,3
1922073,79,26,1934,4,male,374,51,39,0,1,0,1,0,0
1934356,21,27,1992,4,female,156,51,41,0,0,0,0,0,0
2050988,13,10,2000,5,male,758,50,20,0,0,0,0,0,0
1065630,15,3,1998,6,female,432,51,23,0,0,0,0,0,0
1540243,14,22,1999,7,male,609,51,23,0,0,0,0,0,0
1489504,14,15,1999,10,female,805,51,37,0,0,0,0,0,0
2075067,14,15,1999,10,male,680,51,42,0,0,0,0,0,0
1874856,14,25,1999,1,male,324,51,1,0,4,0,3,0,1
1080675,14,13,1999,3,male,539,50,40,0,0,0,0,0,0
1501528,14,18,1999,3,male,283,51,44,0,0,0,0,0,0
2000099,16,29,1997,4,male,436,51,37,0,1,0,0,0,1
2090943,15,1,1998,10,male,108,51,33,0,9,0,8,0,1
1656534,15,8,1998,12,male,35,50,49,0,0,0,0,0,0
1258514,15,16,1998,1,male,124,50,45,0,1,0,1,0,0
1566410,15,13,1998,1,male,80,50,45,0,0,0,0,0,0
1730778,15,27,1998,4,female,76,51,44,0,3,0,3,0,0
2119105,15,18,1998,5,male,340,50,41,0,0,0,0,0,0
1586816,15,17,1998,6,male,316,50,32,0,0,0,0,0,0
1829818,15,8,1998,7,female,443,50,4,0,0,0,0,0,0
1820549,17,4,1996,1,male,53,51,46,0,0,0,0,0,0
1662547,16,8,1997,9,male,215,50,44,0,4,0,3,0,1
1715255,16,11,1997,10,female,523,51,32,0,0,0,0,0,0
1944412,16,27,1997,11,male,524,51,39,0,13,0,8,0,5
1719279,16,25,1997,11,male,523,50,35,0,0,0,0,0,0
1574987,17,30,1996,1,male,220,51,24,0,0,0,0,0,0
1183549,17,14,1996,3,male,395,51,36,0,0,0,0,0,0
1026126,17,19,1996,3,male,448,51,31,0,2,0,2,0,0
1903093,17,8,1996,4,male,434,51,46,0,11,0,8,0,3
1424168,17,27,1996,12,male,254,51,38,0,0,0,0,0,0
1313613,17,16,1996,2,male,654,50,42,0,19,0,7,0,12
1428586,17,25,1996,5,female,974,51,12,0,1,0,0,0,1
1483566,17,13,1996,5,female,507,51,13,0,3,0,1,0,2
1195173,18,8,1995,6,male,319,51,37,0,6,0,0,0,6
1868348,18,4,1995,8,male,415,50,21,0,0,0,0,0,0
1267096,18,26,1995,1,male,181,51,13,0,2,0,2,0,0
2118158,18,18,1995,3,male,110,51,37,0,0,0,0,0,0
1790143,18,25,1995,5,female,373,51,17,0,3,0,1,0,2
1570906,18,22,1995,8,male,206,50,3,0,0,0,0,0,0
1871308,18,23,1995,12,male,415,50,33,0,0,0,0,0,0
1014168,18,25,1995,12,male,275,50,40,0,2,0,0,0,2
1205564,18,28,1995,12,female,247,50,11,0,0,0,0,0,0
1851368,18,9,1995,12,male,246,51,51,0,0,0,0,0,0
1273624,18,12,1995,2,female,452,50,19,0,0,0,0,0,0
1644432,18,9,1995,4,male,728,51,25,0,0,0,0,0,0
1258951,20,25,1993,4,male,289,51,27,0,0,0,0,0,0
2044124,20,19,1993,7,female,544,50,25,0,0,0,0,0,0
1915594,20,13,1993,8,male,619,51,35,0,3,0,3,0,0
1560249,19,21,1994,9,female,443,50,2,0,4,0,2,0,2
1806756,19,27,1994,7,male,232,51,16,0,1,0,1,0,0
1739413,19,18,1994,9,male,724,51,24,0,0,0,0,0,0
1324752,19,5,1994,2,male,517,50,24,0,0,0,0,0,0
1385426,19,23,1994,2,male,443,50,39,0,0,0,0,0,0
2100736,19,21,1994,4,male,926,51,28,0,3,0,1,0,2
2135154,20,1,1993,10,female,411,51,27,0,4,0,4,0,0
1599558,20,23,1993,2,male,129,51,51,0,0,0,0,0,0
2169035,20,20,1993,4,male,352,50,22,0,0,0,0,0,0
1994030,20,28,1993,2,male,261,50,36,0,0,0,0,0,0
2050380,20,11,1993,8,male,526,51,32,0,2,0,2,0,0
1227724,20,25,1993,11,male,500,51,40,0,0,0,0,0,0
1040899,22,19,1991,1,male,242,51,34,0,0,0,0,0,0
1969439,22,10,1991,2,female,312,51,34,0,0,0,0,0,0
1808253,22,19,1991,2,male,1183,51,9,0,0,0,0,0,0
1255117,21,14,1992,8,male,498,50,50,0,0,0,0,0,0
1110845,21,1,1992,10,male,214,51,19,0,0,0,0,0,0
1484488,21,1,1992,4,male,748,51,38,0,0,0,0,0,0
1631584,21,30,1992,4,female,152,50,41,0,0,0,0,0,0
1327898,21,2,1992,1,male,533,51,11,0,4,0,1,0,3
1052243,21,13,1992,2,male,1397,50,13,0,0,0,0,0,0
2000550,21,10,1992,2,male,756,51,41,0,0,0,0,0,0
2099806,21,1,1992,3,male,473,51,32,0,0,0,0,0,0
2024383,23,26,1990,3,male,471,51,22,0,0,0,0,0,0
1756673,22,20,1991,5,male,401,50,45,0,0,0,0,0,0
1273096,22,9,1991,6,male,483,51,11,0,11,0,2,0,9
1345552,22,6,1991,3,female,402,50,19,0,0,0,0,0,0
1875423,24,25,1989,5,male,1095,51,23,0,0,0,0,0,0
1967759,23,13,1990,5,male,304,50,18,0,5,0,0,0,5
1635335,23,10,1990,9,female,916,51,14,0,0,0,0,0,0
1850557,23,15,1990,10,male,783,50,11,0,0,0,0,0,0
1893774,23,22,1990,6,male,318,50,38,0,1,0,1,0,0
1044423,23,29,1990,2,female,1166,51,22,0,0,0,0,0,0
1652420,23,31,1990,2,male,1080,50,21,0,0,0,0,0,0
1867521,24,30,1989,4,male,658,51,31,0,0,0,0,0,0
1255264,24,14,1989,5,male,260,51,36,0,0,0,0,0,0
1337111,24,9,1989,8,male,469,50,30,0,0,0,0,0,0
2150614,24,21,1989,7,female,182,51,28,0,0,0,0,0,0
1418053,24,14,1989,7,male,56,50,9,0,0,0,0,0,0
2042137,24,27,1989,11,female,1352,50,21,0,0,0,0,0,0
1554474,26,24,1987,1,male,1588,51,26,0,0,0,0,0,0
1429268,26,24,1987,1,female,1484,51,29,0,0,0,0,0,0
1053810,25,1,1988,5,male,1458,51,33,0,2,0,0,0,2
1150077,25,14,1988,9,male,1382,50,22,0,8,0,0,0,8
1127944,25,20,1988,10,male,1458,50,18,0,1,0,1,0,0
1752291,25,3,1988,4,male,386,51,48,0,5,0,5,0,0
1130034,25,30,1988,11,female,522,51,27,0,0,0,0,0,0
1389148,25,14,1988,1,male,1172,50,44,0,0,0,0,0,0
1128941,25,8,1988,3,male,1137,51,11,0,2,0,1,0,1
1054559,25,17,1988,5,female,284,50,37,0,1,0,0,0,1
1353294,25,20,1988,4,male,483,51,19,0,2,0,2,0,0
2116656,25,1,1988,11,male,1635,51,12,0,1,0,0,0,1
1575940,25,28,1988,1,male,1206,50,15,0,0,0,0,0,0
1676672,25,17,1988,7,female,1539,51,35,0,1,0,0,0,1
1533119,25,28,1988,8,male,1042,50,25,0,0,0,0,0,0
1272101,26,1,1987,10,female,985,51,31,0,1,0,0,0,1
2008256,26,15,1987,7,female,652,51,25,0,4,0,4,0,0
1936147,26,29,1987,7,male,291,51,45,0,0,0,0,0,0
1274687,26,17,1987,9,female,445,51,30,0,0,0,0,0,0
2032676,26,23,1987,8,male,518,50,16,0,22,0,22,0,0
1091317,28,7,1985,9,female,1065,50,25,0,0,0,0,0,0
1839846,27,12,1986,10,female,580,51,13,0,0,0,0,0,0
1674000,27,8,1986,12,male,1373,51,26,0,11,0,2,0,9
1142659,27,3,1986,1,female,563,50,30,0,0,0,0,0,0
1206680,27,29,1986,7,female,216,50,42,0,1,0,1,0,0
1115635,27,17,1986,10,female,157,50,25,0,0,0,0,0,0
1295322,27,8,1986,11,male,273,50,33,0,3,0,1,0,2
1648208,28,5,1985,2,male,1163,51,27,0,0,0,0,0,0
2188045,28,28,1985,5,female,2200,51,20,0,0,0,0,0,0
1193741,28,26,1985,7,male,1406,50,21,0,0,0,0,0,0
1234145,30,20,1983,9,female,412,51,9,0,0,0,0,0,0
2094637,30,11,1983,6,female,370,51,43,0,0,0,0,0,0
1443751,29,7,1984,12,male,1118,51,29,0,0,0,0,0,0
1410290,29,23,1984,2,male,623,50,35,0,0,0,0,0,0
1811319,29,8,1984,6,female,1654,50,30,0,1,0,1,0,0
1876877,29,3,1984,7,male,243,51,47,0,0,0,0,0,0
1763938,31,16,1982,2,female,210,50,20,1,0,0,0,1,0
1978252,30,12,1983,4,female,324,51,36,1,0,0,0,1,0
1038362,30,28,1983,3,male,348,50,47,1,0,0,0,1,0
2127722,30,24,1983,5,male,452,51,44,1,0,0,0,1,0
1705845,30,2,1983,7,male,117,50,21,1,0,0,0,1,0
1945062,30,7,1983,9,male,594,50,37,1,0,0,0,1,0
1157199,31,6,1982,9,male,390,50,28,1,0,0,0,1,0
1639954,31,2,1982,4,male,603,51,51,1,0,0,0,1,0
1653297,31,13,1982,4,male,815,51,29,1,0,0,0,1,0
1794179,31,24,1982,8,male,181,51,37,1,0,0,0,1,0
1670862,33,10,1980,6,female,420,51,0,1,0,0,0,1,0
1578994,33,22,1980,6,male,250,51,47,1,0,0,0,1,0
1965733,33,29,1980,1,male,256,50,34,1,1,0,0,1,1
1320402,33,10,1980,10,female,369,50,42,1,1,0,1,1,0
1413604,32,18,1981,5,male,1102,50,31,1,1,0,0,1,1
2129882,32,19,1981,2,male,1152,51,24,1,1,0,1,1,0
1095198,32,14,1981,11,female,359,50,34,1,1,0,0,1,1
1925574,32,19,1981,9,male,370,50,47,1,4,0,1,1,3
1046062,32,11,1981,12,male,286,51,31,1,4,0,4,1,0
1615898,32,29,1981,8,female,299,50,11,1,5,0,3,1,2
1448340,33,19,1980,6,male,635,51,11,1,5,0,2,1,3
1736225,33,10,1980,10,male,708,51,19,1,2,0,2,1,0
1124200,36,18,1977,7,male,946,50,29,1,10,0,3,1,7
1283703,36,8,1977,1,female,812,50,23,1,3,0,2,1,1
1481242,37,4,1976,5,male,1702,51,21,1,2,0,1,1,1
1516185,37,14,1976,4,male,1736,50,12,1,12,0,6,1,6
1722216,38,12,1975,8,male,148,51,16,1,0,1,0,0,0
1070763,38,20,1975,9,female,116,51,35,1,0,1,0,0,0
1894255,39,5,1974,3,male,104,50,38,1,0,1,0,0,0
1194407,39,26,1974,1,male,101,50,44,1,0,1,0,0,0
1926777,41,15,1972,12,female,428,50,11,1,0,1,0,0,0
1407921,40,5,1973,7,male,420,50,39,1,0,1,0,0,0
1968313,40,1,1973,10,male,402,50,36,1,0,1,0,0,0
1890717,41,27,1972,1,female,256,51,34,1,0,1,0,0,0
1128947,41,19,1972,12,male,430,50,43,1,0,1,0,0,0
1001623,41,15,1972,3,male,417,51,15,1,0,1,0,0,0
1595209,42,28,1971,5,male,417,51,40,1,0,1,0,0,0
1529705,42,12,1971,7,male,250,51,22,1,0,1,0,0,0
1623984,43,14,1970,1,female,535,50,20,1,0,1,0,0,0
1914212,43,18,1970,4,female,261,51,18,1,0,1,0,0,0
1569552,43,14,1970,4,male,158,50,41,1,0,1,0,0,0
1970701,43,17,1970,1,male,446,50,23,1,0,1,0,0,0
1724847,43,8,1970,7,male,179,51,40,1,0,1,0,0,0
1569110,43,12,1970,5,male,414,50,13,1,0,1,0,0,0
1245674,43,5,1970,5,female,435,51,25,1,0,1,0,0,0
1441762,45,10,1968,2,male,233,51,27,1,0,1,0,0,0
1862442,46,11,1967,1,male,249,51,20,1,0,1,0,0,0
2014127,46,13,1967,12,male,370,50,23,1,0,1,0,0,0
1549695,46,5,1967,12,male,220,50,40,1,0,1,0,0,0
2091006,47,13,1966,1,female,119,50,25,1,0,1,0,0,0
1338760,48,22,1965,3,male,297,50,43,1,0,1,0,0,0
1601735,49,28,1964,11,male,1508,50,28,1,0,1,0,0,0
1646600,50,22,1963,5,male,62,51,45,1,1,1,0,0,1
1186091,50,18,1963,1,female,449,51,26,1,1,1,1,0,0
2120524,50,17,1963,10,male,215,50,21,1,1,1,1,0,0
1846554,50,22,1963,5,male,335,50,29,1,1,1,1,0,0
1622703,51,26,1962,9,male,135,50,24,1,1,1,1,0,0
1933516,51,11,1962,1,male,435,50,35,1,1,1,1,0,0
2179724,53,5,1960,8,male,655,51,27,1,1,1,1,0,0
2035013,52,8,1961,3,female,1231,51,15,1,1,1,1,0,0
2117582,52,10,1961,7,male,135,51,30,1,2,1,2,0,0
1917839,52,29,1961,5,male,234,50,42,1,2,1,1,0,1
1103129,53,5,1960,8,male,323,51,47,1,5,1,1,0,4
1464831,53,24,1960,10,male,221,50,37,1,9,1,5,0,4
1341158,55,27,1958,6,female,442,50,33,1,2,1,2,0,0
1692391,59,18,1954,4,male,495,50,24,1,12,1,11,0,1
1179551,58,1,1955,7,male,134,51,22,1,3,1,3,0,0
1049811,59,6,1954,6,female,883,51,14,1,3,1,3,0,0
1475563,59,24,1954,1,male,91,50,47,1,4,1,4,0,0
1778874,62,17,1951,8,female,480,51,31,1,3,1,2,0,1
1103576,64,9,1949,7,male,323,50,35,1,8,1,2,0,6
2107105,63,6,1950,7,female,293,51,31,1,2,1,1,0,1
1756069,63,27,1950,10,male,138,51,36,1,7,1,6,0,1
2170094,64,29,1949,3,male,269,50,36,1,4,1,4,0,0
2078151,64,10,1949,8,male,161,50,37,1,2,1,2,0,0
2188334,65,7,1948,5,male,401,51,8,1,3,1,2,0,1
2106045,65,22,1948,11,female,422,50,31,1,8,1,8,0,0
1271595,65,28,1948,12,female,1112,51,19,1,2,1,2,0,0
1709420,66,28,1947,9,female,529,51,17,1,7,1,6,0,1
1719357,66,15,1947,8,female,186,51,25,1,2,1,2,0,0
1409040,71,12,1942,1,male,1821,51,19,1,25,1,16,0,9
2149645,73,29,1940,6,male,493,51,44,2,0,0,0,2,0
1364863,72,25,1941,11,male,880,50,20,2,0,0,0,2,0
1614283,72,28,1941,9,female,184,50,27,2,2,0,2,2,0
1017823,73,19,1940,4,male,429,51,26,2,2,0,0,2,2
1110072,76,10,1937,10,female,381,50,22,2,2,0,0,2,2
1687865,75,8,1938,9,female,250,50,35,2,8,0,2,2,6
1257534,76,9,1937,1,male,355,51,32,2,12,0,5,2,7
1489361,76,28,1937,1,male,339,51,39,2,10,0,5,2,5
1502001,95,9,1918,1,male,85,50,33,2,17,0,8,2,9
2152739,97,9,1916,3,male,631,51,37,2,7,0,4,2,3
1386179,103,18,1910,1,male,406,51,35,2,12,0,6,2,6
2146321,108,27,1905,7,female,793,51,31,2,7,0,4,2,3
2069677,108,17,1905,11,female,549,51,44,2,6,0,3,2,3
1916863,108,5,1905,10,male,531,51,25,2,49,0,7,2,42
1312567,13,14,2000,5,female,1362,50,29,2,5,0,3,2,2
2163477,15,16,1998,7,male,66,51,37,2,12,0,0,2,12
1126930,18,17,1995,5,male,614,50,22,2,3,0,3,2,0
1463585,20,18,1993,5,male,109,50,43,2,131,0,13,2,118
1068541,30,27,1983,6,male,1826,50,23,2,4,0,2,2,2
1251635,31,2,1982,6,male,1327,51,42,2,0,1,0,1,0
1191636,41,20,1972,8,male,108,51,39,2,19,1,17,1,2
1319013,43,5,1970,6,male,156,50,39,2,0,2,0,0,0
1285674,45,30,1968,4,female,355,51,11,2,0,2,0,0,0
1114090,54,28,1959,11,female,466,51,26,2,0,2,0,0,0
1193815,55,29,1958,8,female,395,51,35,2,0,2,0,0,0
1831315,60,14,1953,2,male,248,51,24,2,0,2,0,0,0
2037280,17,3,1996,1,male,275,50,17,2,0,2,0,0,0
1695851,50,3,1963,11,male,34,51,49,2,0,2,0,0,0
1440866,57,9,1956,12,male,76,50,34,2,1,2,1,0,0
1250066,70,20,1943,5,male,162,51,43,2,1,2,1,0,0
1097938,90,2,1923,9,male,406,51,25,2,1,2,1,0,0
1304792,22,16,1991,12,male,405,51,42,2,1,2,1,0,0
1973850,49,2,1964,6,male,631,50,19,2,1,2,1,0,0
1169694,53,20,1960,8,male,78,50,46,2,1,2,1,0,0
1321385,54,12,1959,8,male,396,50,42,2,2,2,2,0,0
1769036,59,22,1954,3,male,80,50,36,2,2,2,2,0,0
1559998,61,8,1952,5,male,275,50,28,2,2,2,2,0,0
1204028,62,31,1951,12,female,700,51,41,2,4,2,4,0,0
1939546,70,12,1943,5,male,230,50,15,2,9,2,8,0,1
1027006,72,26,1941,9,female,452,51,35,2,10,2,7,0,3
1775409,15,12,1998,5,female,206,50,14,2,7,2,4,0,3
1194385,15,23,1998,1,male,32,50,42,2,16,2,5,0,11
2113544,16,9,1997,6,male,157,51,45,2,10,2,10,0,0
1185657,18,16,1995,1,male,139,50,36,2,17,2,8,0,9
1119520,21,26,1992,5,male,456,50,20,2,4,2,3,0,1
1207359,22,2,1991,3,male,201,51,31,2,15,2,9,0,6
1675365,22,23,1991,10,female,278,50,38,2,4,2,2,0,2
1219005,23,8,1990,8,female,784,51,28,2,24,2,22,0,2
1588263,25,28,1988,6,female,249,51,42,3,1,0,1,3,0
2025639,25,18,1988,9,male,614,50,30,3,3,0,1,3,2
1378203,26,16,1987,7,male,501,51,23,3,17,0,3,3,14
1846398,26,31,1987,10,female,1429,51,22,3,24,0,5,3,19
1735429,28,11,1985,7,male,599,51,36,3,8,0,5,3,3
2165121,29,18,1984,11,female,221,50,30,3,10,0,1,3,9
1794203,29,21,1984,7,male,391,50,41,3,0,2,0,1,0
1540654,32,29,1981,7,male,479,50,31,3,0,2,0,1,0
1964007,32,22,1981,2,male,1946,51,9,3,1,1,1,2,0
1789685,34,9,1979,3,male,42,51,41,3,4,1,1,2,3
1731599,36,11,1977,12,female,231,51,36,3,3,1,1,2,2
1638168,43,22,1970,11,male,323,50,34,3,0,3,0,0,0
1059376,44,1,1969,10,male,218,51,26,3,0,3,0,0,0
2129687,52,7,1961,8,female,239,50,32,3,0,3,0,0,0
1750293,55,3,1958,1,male,476,50,38,3,0,3,0,0,0
2055495,62,31,1951,8,male,1153,51,16,3,0,3,0,0,0
2022497,62,14,1951,7,female,694,50,39,3,0,3,0,0,0
2036326,70,7,1943,6,female,440,50,16,3,1,3,1,0,0
1062368,21,15,1992,8,male,312,50,18,3,3,3,3,0,0
1911657,27,3,1986,8,male,130,50,23,3,3,3,3,0,0
1579990,37,10,1976,11,male,243,51,12,3,2,3,2,0,0
1229158,46,25,1967,11,male,108,51,28,3,2,3,2,0,0
1021462,47,18,1966,5,female,350,51,27,3,2,3,2,0,0
1763875,49,3,1964,5,female,82,51,33,3,7,3,6,0,1
1509345,68,17,1945,11,male,186,50,15,3,36,3,28,0,8
1946755,79,16,1934,3,female,581,51,12,3,96,3,75,0,21
1945716,16,17,1997,6,male,560,51,25,3,6,3,6,0,0
2075521,17,1,1996,2,male,76,51,43,3,7,3,6,0,1
1779931,19,3,1994,10,female,177,50,33,3,8,3,8,0,0
1861448,19,27,1994,1,male,755,50,43,3,10,3,6,0,4
1090883,21,21,1992,2,male,215,51,48,4,2,0,0,4,2
2081613,23,14,1990,12,female,349,51,28,4,1,0,1,4,0
1204882,24,15,1989,4,male,303,51,42,4,1,0,0,4,1
2032750,28,6,1985,10,male,537,50,27,4,0,1,0,3,0
1839306,29,11,1984,5,male,1860,50,31,4,2,1,2,3,0
1672008,29,10,1984,11,male,109,51,49,4,8,2,3,2,5
1317854,31,8,1982,3,female,471,51,31,4,50,2,20,2,30
2057768,31,6,1982,4,male,394,51,25,4,12,1,8,3,4
1962813,36,10,1977,8,male,1807,50,15,4,7,3,5,1,2
1964942,37,23,1976,4,male,90,51,41,4,0,4,0,0,0
1297826,37,17,1976,8,male,68,50,46,4,0,4,0,0,0
1170784,44,5,1969,11,male,341,51,26,4,0,4,0,0,0
1010837,48,23,1965,12,male,997,51,3,4,0,4,0,0,0
2180424,57,15,1956,9,male,331,50,30,4,0,4,0,0,0
1621993,60,25,1953,12,male,180,50,34,4,1,4,0,0,1
2182521,64,14,1949,2,male,220,51,40,4,2,4,0,0,2
1755986,70,8,1943,3,female,528,50,39,4,1,4,1,0,0
1809378,18,19,1995,6,male,448,50,40,4,3,4,3,0,0
2124155,20,22,1993,8,male,73,51,36,4,3,4,2,0,1
1410479,41,29,1972,11,male,964,51,31,4,3,4,1,0,2
1022914,52,24,1961,1,female,298,50,4,4,18,4,17,0,1
1548625,66,11,1947,2,male,39,51,39,4,8,4,0,0,8
1220763,18,3,1995,11,female,222,50,43,4,43,4,19,0,24
1619727,20,1,1993,11,female,142,50,42,4,12,4,10,0,2
1014272,23,2,1990,10,female,463,51,37,4,20,4,16,0,4
2175240,26,23,1987,6,male,396,51,7,5,0,0,0,5,0
2062620,46,29,1967,1,male,1495,51,30,5,0,0,0,5,0
1156538,51,29,1962,5,male,1754,50,21,5,2,0,1,5,1
1820214,55,24,1958,7,male,1708,51,27,5,5,0,3,5,2
1560719,60,16,1953,10,male,29,51,28,5,5,0,3,5,2
1481688,61,11,1952,3,female,478,51,27,5,15,0,7,5,8
1291109,62,12,1951,5,female,158,51,12,5,9,0,4,5,5
1502430,62,20,1951,2,male,445,50,31,5,8,0,0,5,8
1280308,71,18,1942,8,male,567,51,28,5,2,3,2,2,0
1011205,74,15,1939,10,female,445,50,43,5,18,4,10,1,8
1869974,75,3,1938,9,male,57,50,46,5,0,5,0,0,0
1511782,64,6,1949,2,female,561,50,41,5,0,5,0,0,0
2117200,18,20,1995,12,male,305,51,43,5,0,5,0,0,0
1517181,17,20,1996,8,male,559,51,41,5,3,5,2,0,1
1455250,19,13,1994,9,female,268,50,28,5,1,5,0,0,1
1240815,30,12,1983,12,female,253,50,21,5,2,5,2,0,0
1579173,31,28,1982,12,male,443,50,6,5,1,5,0,0,1
1449954,33,12,1980,2,male,362,51,45,5,3,5,1,0,2
1647105,39,23,1974,1,female,153,51,33,5,2,5,1,0,1
1859684,46,21,1967,5,male,688,51,10,5,1,5,1,0,0
1204890,14,25,1999,1,male,341,51,45,5,6,5,2,0,4
1897446,16,4,1997,2,female,71,50,26,5,46,5,41,0,5
1222320,33,11,1980,6,male,450,51,46,5,66,5,50,0,16
1449900,40,29,1973,1,male,159,50,39,5,72,5,36,0,36
1505904,41,25,1972,4,male,797,51,29,6,0,0,0,6,0
1259852,48,1,1965,8,male,1982,50,19,6,3,0,2,6,1
2091055,19,15,1994,11,female,2036,50,11,6,2,0,2,6,0
1915432,23,16,1990,8,male,78,51,41,6,9,0,8,6,1
1920996,33,1,1980,1,male,11,51,46,6,21,3,18,3,3
1069017,19,21,1994,2,female,164,50,29,6,15,4,5,2,10
1039288,19,10,1994,1,female,22,51,34,6,92,5,32,1,60
1962882,21,3,1992,12,female,8,50,10,6,1,6,1,0,0
1051558,24,24,1989,7,male,1072,51,39,6,2,6,2,0,0
1842060,25,1,1988,1,male,93,50,34,6,1,6,1,0,0
2122373,25,9,1988,7,male,62,50,47,6,3,6,1,0,2
1801264,33,29,1980,11,male,223,51,27,6,4,6,4,0,0
2153561,34,16,1979,9,male,1456,50,20,6,5,6,1,0,4
1990611,38,24,1975,4,male,257,51,34,6,12,6,1,0,11
1406376,65,20,1948,10,male,159,51,28,6,29,6,10,0,19
1048048,100,23,1913,12,male,311,51,44,7,0,0,0,7,0
1793836,59,24,1954,9,female,270,51,35,7,1,0,1,7,0
1094904,16,9,1997,9,male,364,50,34,7,1,0,0,7,1
1101364,26,29,1987,7,female,1865,51,24,7,0,0,0,7,0
1122742,30,26,1983,11,male,668,51,34,7,4,0,0,7,4
1743483,33,13,1980,3,female,198,50,42,7,4,0,0,7,4
1421656,53,1,1960,1,male,1814,51,4,7,6,1,6,6,0
1813190,21,23,1992,8,male,1495,50,18,7,18,0,3,7,15
2083304,49,15,1964,10,male,305,51,36,7,8,4,0,3,8
1059950,56,16,1957,7,male,228,51,21,7,20,4,7,3,13
1182962,15,4,1998,8,male,396,51,49,7,1,7,0,0,1
1222647,32,16,1981,9,male,850,50,25,7,0,7,0,0,0
1802306,16,21,1997,1,male,807,51,40,7,1,7,1,0,0
1559204,24,1,1989,11,female,339,50,41,7,2,7,2,0,0
1111339,25,7,1988,12,female,1672,51,24,7,4,7,4,0,0
1337825,47,12,1966,8,male,626,50,29,7,3,7,2,0,1
1241689,53,15,1960,3,male,132,51,44,7,9,7,9,0,0
1085052,54,11,1959,2,female,407,50,27,7,5,7,5,0,0
1595473,42,20,1971,1,female,91,51,30,7,5,7,3,0,2
1185740,16,8,1997,11,male,312,50,32,7,47,7,43,0,4
1134740,23,21,1990,3,male,913,51,28,7,12,7,7,0,5
1478514,25,28,1988,10,male,426,51,33,7,20,7,12,0,8
2174872,40,4,1973,7,male,85,51,34,7,13,7,5,0,8
2121747,40,22,1973,11,male,782,50,24,7,19,7,13,0,6
1116531,16,28,1997,8,male,349,51,46,8,1,0,1,8,0
1104804,20,20,1993,2,male,1729,51,15,8,0,0,0,8,0
1680944,25,22,1988,1,male,576,50,24,8,2,0,0,8,2
1079009,27,18,1986,10,male,1480,51,18,8,4,0,2,8,2
1131642,28,28,1985,4,female,1707,51,25,8,6,0,0,8,6
1055974,53,19,1960,9,female,1589,51,28,8,7,0,0,8,7
1225773,68,3,1945,12,male,530,50,15,8,14,0,0,8,14
1148590,19,4,1994,9,male,789,51,24,8,3,4,2,4,1
2184478,26,31,1987,1,male,394,51,38,8,6,3,5,5,1
1771698,71,30,1942,10,female,682,50,22,8,22,5,19,3,3
1941235,31,1,1982,6,female,535,51,27,8,0,7,0,1,0
1158227,61,13,1952,1,male,489,51,41,8,1,8,1,0,0
1136226,23,5,1990,11,female,854,50,29,8,0,8,0,0,0
1027514,27,7,1986,8,male,78,50,45,8,2,8,1,0,1
1211844,50,9,1963,11,female,84,50,23,8,4,8,3,0,1
1962153,57,15,1956,1,male,407,50,35,8,3,8,3,0,0
1471611,22,10,1991,9,male,109,51,16,8,9,8,6,0,3
1627230,24,3,1989,6,male,246,51,36,8,9,8,5,0,4
1118766,33,28,1980,2,female,1803,51,18,8,9,8,4,0,5
1328224,36,5,1977,7,female,117,51,34,8,17,8,14,0,3
1468154,42,25,1971,9,male,342,51,44,8,14,8,10,0,4
1968770,22,13,1991,6,female,477,51,24,8,12,8,11,0,1
1367759,46,6,1967,7,female,217,51,41,9,1,0,0,9,1
1176552,49,12,1964,1,male,394,51,28,9,1,0,1,9,0
1877908,15,17,1998,5,male,553,50,46,9,0,0,0,9,0
1486799,19,6,1994,4,female,800,51,43,9,1,0,0,9,1
1689781,65,15,1948,12,male,1409,50,33,9,2,0,0,9,2
1059496,15,10,1998,3,male,650,51,44,9,51,0,25,9,26
1027655,17,2,1996,10,male,255,50,41,9,139,0,10,9,129
1479484,32,10,1981,7,male,1665,50,31,9,28,1,7,8,21
1072283,33,11,1980,8,female,1566,50,37,9,0,3,0,6,0
1986965,42,20,1971,1,male,1315,50,28,9,4,4,0,5,4
1129347,46,7,1967,1,male,105,51,21,9,13,3,9,6,4
2052821,73,6,1940,9,female,697,51,35,9,7,2,2,7,5
1919829,62,26,1951,7,female,408,50,36,9,2,7,0,2,2
1607164,43,14,1970,3,male,620,51,34,9,0,9,0,0,0
1483304,59,30,1954,7,male,229,50,22,9,1,9,1,0,0
2098169,36,24,1977,3,female,185,50,29,9,0,9,0,0,0
1302859,59,11,1954,4,male,315,50,40,9,3,9,3,0,0
1563456,60,10,1953,11,male,314,51,43,9,7,9,4,0,3
1578151,19,18,1994,9,female,464,50,44,9,10,9,9,0,1
2168671,58,9,1955,8,male,261,51,37,9,42,9,39,0,3
2152877,18,12,1995,11,male,212,51,48,9,24,9,19,0,5
1461947,22,4,1991,11,male,483,51,7,9,29,9,28,0,1
1899363,58,1,1955,10,male,194,51,31,10,1,0,1,10,0
1362018,17,30,1996,10,male,324,50,38,10,11,0,0,10,11
1773881,29,7,1984,5,female,603,50,20,10,53,0,31,10,22
1124774,34,4,1979,7,female,1663,51,20,10,21,0,10,10,11
2163293,36,25,1977,6,male,977,50,26,10,3,7,3,3,0
1935662,38,10,1975,12,male,149,50,40,10,0,10,0,0,0
1910470,43,1,1970,9,female,2045,50,39,10,3,10,1,0,2
1854377,59,27,1954,3,male,301,51,24,10,7,10,7,0,0
1110127,26,10,1987,7,male,164,51,25,10,17,10,13,0,4
1046943,16,19,1997,8,female,142,50,23,10,23,10,10,0,13
2038450,29,26,1984,3,female,257,51,21,10,43,10,33,0,10
1106833,41,1,1972,8,female,884,50,5,11,0,2,0,9,0
1590274,63,15,1950,2,male,332,50,47,11,1,1,1,10,0
1067064,41,11,1972,1,male,120,50,45,11,3,0,1,11,2
1457263,65,23,1948,3,male,427,51,35,11,6,0,1,11,5
1741931,23,22,1990,8,male,403,51,36,11,10,0,3,11,7
2158269,18,1,1995,8,female,704,50,31,11,44,0,13,11,31
2087659,52,7,1961,5,female,1402,50,31,11,0,7,0,4,0
1077851,28,1,1985,3,male,607,50,38,11,6,3,6,8,0
1769026,20,27,1993,11,male,501,51,32,11,11,7,7,4,4
1164949,23,7,1990,7,female,363,50,31,11,30,9,25,2,5
1862685,25,1,1988,4,male,990,51,24,11,1,11,1,0,0
1071161,25,8,1988,3,female,681,50,27,11,0,11,0,0,0
1185534,22,26,1991,11,male,326,51,48,11,5,11,5,0,0
2041370,53,13,1960,3,male,102,50,22,11,4,11,4,0,0
2062075,18,24,1995,5,male,775,50,24,11,2,11,2,0,0
1134396,27,1,1986,3,female,391,51,36,11,2,11,2,0,0
1042607,14,7,1999,1,male,136,51,49,11,8,11,8,0,0
1622849,23,10,1990,1,male,251,50,37,11,33,11,13,0,20
1391640,43,25,1970,5,female,648,50,39,11,36,11,28,0,8
1037030,66,4,1947,6,male,461,51,16,12,0,0,0,12,0
1375806,62,5,1951,3,male,142,51,36,12,10,1,8,11,2
2042815,66,17,1947,7,male,38,50,48,12,5,12,5,0,0
2164793,89,19,1924,7,female,666,50,18,12,5,12,4,0,1
1691604,66,6,1947,6,female,624,50,36,12,10,12,7,0,3
1450149,39,1,1974,1,female,359,50,18,12,18,12,7,0,11
1416420,18,8,1995,5,female,717,50,41,13,2,2,2,11,0
1159217,28,7,1985,2,female,648,50,11,13,6,0,3,13,3
2092759,32,9,1981,5,female,514,50,29,13,4,0,0,13,4
1916213,39,31,1974,1,female,607,50,36,13,2,5,0,8,2
2137559,40,15,1973,2,male,89,51,31,13,0,13,0,0,0
1618145,42,10,1971,10,female,245,50,42,13,26,13,10,0,16
1190259,94,12,1919,3,male,854,51,45,14,5,0,2,14,3
1063914,13,5,2000,8,male,706,51,12,14,6,0,0,14,6
1104044,19,27,1994,9,male,54,51,47,14,12,1,6,13,6
1786429,24,12,1989,6,female,141,51,34,14,99,0,24,14,75
2167721,20,25,1993,4,male,119,50,39,14,37,7,11,7,26
1708453,28,25,1985,11,female,153,51,28,14,0,14,0,0,0
1683073,40,22,1973,2,male,228,51,15,14,2,14,2,0,0
1091199,41,21,1972,3,male,652,50,31,14,0,14,0,0,0
1985167,50,27,1963,4,female,426,50,31,14,2,14,2,0,0
2060195,34,21,1979,6,female,21,50,41,14,4,14,3,0,1
1262711,56,2,1957,9,male,27,50,43,14,4,14,0,0,4
1011163,57,17,1956,8,male,534,50,26,14,6,14,6,0,0
1585032,65,28,1948,6,male,649,50,34,14,6,14,5,0,1
1353349,48,7,1965,7,male,225,51,32,14,16,14,14,0,2
1036815,58,25,1955,10,male,168,51,34,14,68,14,2,0,66
1336861,55,28,1958,4,male,2058,51,31,15,1,0,0,15,1
1821098,69,12,1944,3,male,1755,51,25,15,8,0,7,15,1
2080669,23,16,1990,6,male,245,50,28,15,30,0,12,15,18
2015449,31,21,1982,4,male,622,50,41,15,21,7,13,8,8
2032415,58,18,1955,11,male,260,50,50,15,9,12,4,3,5
1295593,16,9,1997,4,female,455,50,43,15,22,14,18,1,4
1100812,58,6,1955,8,male,35,50,31,15,2,15,2,0,0
1663291,14,10,1999,3,male,366,51,27,15,8,15,8,0,0
1752080,35,13,1978,10,female,543,50,33,15,57,15,18,0,39
2064912,55,1,1958,11,male,616,51,21,16,11,0,1,16,10
1520806,26,11,1987,10,female,571,50,32,16,35,1,4,15,31
1679120,31,12,1982,10,male,72,51,50,16,8,4,5,12,3
1169427,56,22,1957,2,male,652,50,50,16,0,16,0,0,0
1365463,18,7,1995,1,male,186,51,43,17,3,0,1,17,2
1363153,23,16,1990,2,male,159,50,42,17,4,10,1,7,3
1231614,68,21,1945,12,male,508,51,34,17,7,17,5,0,2
1885618,16,2,1997,10,male,421,51,47,17,4,17,3,0,1
1120830,19,19,1994,6,male,212,50,47,17,16,17,14,0,2
1110575,49,10,1964,7,male,751,50,24,17,16,17,4,0,12
1518291,58,13,1955,11,male,726,50,17,17,24,17,11,0,13
2015208,71,29,1942,3,female,215,50,23,17,29,17,24,0,5
1671952,52,6,1961,9,female,54,51,10,17,46,17,45,0,1
1195375,58,15,1955,6,male,340,51,33,18,5,0,0,18,5
1353472,59,6,1954,9,female,616,50,23,18,36,0,15,18,21
1785842,85,27,1928,6,female,1823,50,13,18,16,12,8,6,8
1751441,54,25,1959,8,female,654,51,19,18,46,17,10,1,36
1915011,22,10,1991,12,female,457,50,39,18,1,18,1,0,0
2151233,63,26,1950,5,male,52,50,50,18,7,18,6,0,1
1345291,67,3,1946,8,male,399,51,37,18,3,18,0,0,3
2193148,17,3,1996,7,female,822,51,29,18,3,18,3,0,0
1338782,18,24,1995,9,female,432,51,25,18,19,18,17,0,2
1239006,27,4,1986,3,male,168,50,26,18,33,18,26,0,7
1432786,37,19,1976,5,male,212,50,29,18,36,18,32,0,4
1763448,48,25,1965,4,male,155,50,23,19,7,14,0,5,7
1946592,52,17,1961,2,male,233,50,45,19,1,19,0,0,1
1428901,21,12,1992,12,male,547,51,43,19,0,19,0,0,0
1200104,24,2,1989,9,female,531,50,37,19,4,19,4,0,0
1879245,36,10,1977,1,female,729,51,23,19,56,19,21,0,35
1492691,25,12,1988,4,female,554,50,21,19,35,19,17,0,18
1323692,44,29,1969,10,male,343,50,20,20,1,6,1,14,0
1713565,66,28,1947,2,male,438,51,48,20,3,16,3,4,0
1010630,75,7,1938,5,female,447,51,19,20,16,16,12,4,4
1203493,108,17,1905,3,NA,1622,50,26,20,26,19,19,1,7
2063127,23,16,1990,6,male,381,50,26,20,0,20,0,0,0
1451950,63,26,1950,1,male,292,51,34,20,10,20,10,0,0
1727839,27,29,1986,7,male,1315,50,18,20,7,20,7,0,0
1010394,30,9,1983,12,female,174,50,22,20,5,20,2,0,3
1008723,30,29,1983,1,male,431,50,39,20,27,20,22,0,5
1628614,52,12,1961,9,male,21,51,41,21,6,18,6,3,0
1751925,18,12,1995,2,male,19,50,49,21,12,21,10,0,2
1314025,24,14,1989,1,male,153,50,49,21,6,21,5,0,1
1986493,18,7,1995,7,female,170,50,45,22,1,0,0,22,1
1877884,18,26,1995,8,male,648,50,23,22,28,0,20,22,8
1156522,77,26,1936,2,female,621,51,19,22,8,22,7,0,1
1565067,54,4,1959,6,female,10,50,45,22,11,22,10,0,1
1338609,80,20,1933,4,female,444,51,16,22,32,22,12,0,20
1315027,27,6,1986,9,male,71,51,26,22,70,22,58,0,12
1440431,48,1,1965,11,female,257,50,35,23,1,0,1,23,0
1558098,52,10,1961,8,male,1725,50,34,23,12,12,1,11,11
1360955,30,1,1983,9,male,382,51,43,23,0,23,0,0,0
1688107,56,21,1957,10,male,877,51,44,23,0,23,0,0,0
1613434,26,6,1987,11,female,67,50,41,23,19,23,15,0,4
1826991,32,16,1981,4,female,43,51,22,23,74,23,71,0,3
1524532,39,22,1974,7,female,430,51,27,23,36,23,21,0,15
1203804,51,24,1962,2,female,172,50,40,23,130,23,130,0,0
1292217,20,1,1993,7,male,36,51,45,24,12,3,3,21,9
1723051,27,1,1986,12,female,207,50,26,24,11,15,10,9,1
1217350,55,31,1958,3,male,489,50,19,24,5,14,1,10,4
1207376,30,30,1983,6,male,102,51,35,24,16,14,8,10,8
1584299,20,18,1993,7,male,493,50,33,24,30,24,26,0,4
1680085,19,3,1994,7,male,46,51,22,25,0,1,0,24,0
1076510,61,21,1952,3,male,338,51,18,25,28,0,7,25,21
1174956,55,18,1958,10,male,488,51,23,25,17,25,14,0,3
1673374,33,1,1980,12,female,299,51,14,25,23,25,22,0,1
1511121,63,19,1950,12,male,1395,50,23,25,19,25,16,0,3
1005617,48,1,1965,9,male,312,51,31,25,39,25,24,0,15
1895658,54,9,1959,3,male,346,51,24,25,42,25,14,0,28
1736451,55,23,1958,12,female,1794,50,19,25,170,25,66,0,104
1485994,33,5,1980,8,male,197,51,45,26,3,0,0,26,3
1095562,65,28,1948,6,male,1020,50,27,26,8,0,5,26,3
1902104,24,4,1989,10,female,1104,51,23,26,68,0,51,26,17
1072591,60,27,1953,7,male,1022,50,36,26,4,26,4,0,0
2168818,67,19,1946,6,male,261,51,35,26,6,26,4,0,2
1234625,69,20,1944,12,male,355,50,30,27,13,0,1,27,12
1234728,15,19,1998,5,female,779,50,41,27,5,27,2,0,3
1652865,15,4,1998,5,male,1140,50,25,27,11,27,10,0,1
1727065,21,6,1992,1,female,360,50,20,27,6,27,6,0,0
1797509,51,25,1962,10,female,37,51,44,27,80,27,78,0,2
1729315,51,23,1962,10,male,10,51,43,28,21,0,9,28,12
1833450,13,21,2000,7,female,662,50,32,28,21,0,0,28,21
1047617,15,9,1998,2,male,94,50,19,28,27,7,11,21,16
1583022,43,12,1970,4,male,193,50,37,28,24,22,5,6,19
1386745,65,30,1948,12,male,310,50,39,28,11,28,7,0,4
2012693,42,10,1971,3,male,428,51,37,28,11,28,6,0,5
1770860,19,4,1994,1,male,89,50,40,28,27,28,15,0,12
2076337,89,1,1924,9,male,28,50,32,28,20,28,19,0,1
1209216,103,19,1910,1,male,146,50,26,29,10,2,3,27,7
1354538,65,29,1948,2,female,1136,51,29,29,39,0,18,29,21
1565363,54,9,1959,3,female,1631,50,34,29,22,2,12,27,10
1249848,49,19,1964,10,male,630,50,39,29,83,0,27,29,56
1457849,22,7,1991,1,female,289,51,39,29,14,17,5,12,9
1016387,25,24,1988,5,male,334,51,43,29,9,26,6,3,3
1572864,20,3,1993,5,male,148,50,44,29,84,29,54,0,30
1400342,27,26,1986,2,female,295,50,25,30,10,1,7,29,3
1331754,34,6,1979,10,female,391,50,40,31,32,0,22,31,10
1722244,42,11,1971,6,male,422,50,34,30,47,0,30,30,17
1705512,58,22,1955,4,male,30,50,44,31,0,31,0,0,0
1632416,29,18,1984,6,male,294,51,49,30,8,30,6,0,2
1087231,64,11,1949,4,female,220,51,28,30,43,30,43,0,0
1368307,25,17,1988,11,male,325,50,24,30,34,30,24,0,10
1877160,24,3,1989,9,male,80,50,41,30,43,30,25,0,18
1952918,52,16,1961,3,female,780,50,37,30,38,30,25,0,13
1942937,29,27,1984,10,female,113,50,37,31,63,31,48,0,15
1605178,51,25,1962,3,male,767,51,33,33,10,0,9,33,1
1720742,70,20,1943,6,male,2210,51,37,33,42,24,33,9,9
2116612,24,13,1989,5,male,1001,50,27,33,81,27,58,6,23
1495930,73,7,1940,3,male,142,50,38,33,0,33,0,0,0
1616870,44,12,1969,8,female,602,51,29,33,20,33,14,0,6
1327140,79,3,1934,7,female,371,51,24,33,16,33,12,0,4
1739113,72,22,1941,7,male,28,51,40,34,15,14,6,20,9
1192245,45,9,1968,3,male,839,51,35,34,13,34,12,0,1
1367181,39,7,1974,6,female,684,51,33,34,88,34,71,0,17
2178133,22,21,1991,4,female,1557,50,28,36,1,3,1,33,0
1498227,44,17,1969,1,female,863,51,31,35,28,0,15,35,13
1364735,66,24,1947,1,female,429,51,17,36,19,16,9,20,10
1181956,57,4,1956,4,male,343,51,24,36,26,12,7,24,19
1270482,17,16,1996,4,female,543,50,19,36,32,35,15,1,17
1501976,17,10,1996,1,male,417,50,17,36,4,36,2,0,2
1637621,20,20,1993,12,female,324,50,37,36,5,36,3,0,2
1793733,18,26,1995,12,female,500,50,36,35,29,35,24,0,5
2060989,29,25,1984,10,female,482,50,19,35,45,35,34,0,11
2157272,70,19,1943,9,male,268,50,34,35,26,35,24,0,2
1729528,22,26,1991,6,male,52,51,29,36,75,36,64,0,11
1195772,35,8,1978,3,male,1056,51,23,36,74,36,55,0,19
1373827,63,23,1950,8,female,1048,50,26,37,4,0,2,37,2
1770185,29,25,1984,2,female,375,50,32,37,4,20,4,17,0
1612275,41,31,1972,7,male,121,51,32,37,2,37,2,0,0
1285804,66,25,1947,5,female,1099,51,16,37,3,37,3,0,0
1341328,32,5,1981,12,male,511,50,32,37,18,37,12,0,6
1899567,25,1,1988,4,female,135,51,37,37,23,37,15,0,8
1681582,48,18,1965,6,male,1028,50,19,37,34,37,28,0,6
2027588,106,1,1907,11,male,267,50,28,38,1,0,0,38,1
1965898,94,1,1919,3,male,148,50,36,38,10,0,5,38,5
1123902,24,26,1989,12,male,522,50,29,39,67,0,4,39,63
2040137,13,19,2000,9,female,429,50,32,39,13,37,8,2,5
1354292,37,15,1976,9,female,63,50,35,39,9,39,9,0,0
1713612,65,20,1948,1,male,855,50,24,38,8,38,5,0,3
1137855,65,4,1948,7,female,160,51,35,39,79,39,19,0,60
1592698,25,25,1988,9,female,211,51,25,39,59,39,31,0,28
1190058,69,22,1944,2,male,248,50,32,40,29,0,16,40,13
1873333,97,8,1916,7,male,647,51,40,40,30,15,24,25,6
1323014,31,28,1982,7,female,219,51,21,40,6,40,4,0,2
1614689,18,6,1995,8,female,221,51,9,40,9,40,8,0,1
1013678,71,24,1942,4,male,14,51,48,40,14,40,11,0,3
1339211,17,7,1996,6,female,704,50,28,42,16,40,10,2,6
1645756,49,29,1964,12,male,534,50,42,41,24,41,13,0,11
1748482,21,28,1992,6,female,684,51,33,41,33,41,21,0,12
1310585,25,15,1988,1,male,1516,50,26,41,46,41,45,0,1
1007808,34,16,1979,6,male,121,50,42,42,323,42,317,0,6
1601424,39,22,1974,10,male,600,50,33,43,3,0,0,43,3
1418559,18,15,1995,11,female,1813,51,23,43,3,0,1,43,2
2092243,23,24,1990,2,female,64,51,38,44,4,44,2,0,2
1304071,41,31,1972,2,female,731,50,14,44,2,44,2,0,0
2052321,51,12,1962,11,female,605,50,34,43,16,43,16,0,0
1575787,54,23,1959,7,male,71,51,24,44,29,44,23,0,6
1315403,15,16,1998,5,male,293,51,26,45,3,0,3,45,0
2032761,51,21,1962,4,female,334,50,15,45,68,43,29,2,39
2139284,31,9,1982,1,female,650,50,40,45,4,45,1,0,3
1799729,50,5,1963,7,female,386,50,41,45,13,45,10,0,3
1207355,63,24,1950,4,female,194,50,23,45,22,45,15,0,7
1601296,22,1,1991,12,male,218,50,40,45,41,45,38,0,3
2040401,23,27,1990,11,female,675,50,16,47,7,0,3,47,4
1598101,49,26,1964,1,male,313,50,38,46,3,7,0,39,3
1881482,23,15,1990,11,female,1185,51,46,46,24,0,3,46,21
1847890,47,3,1966,3,male,671,50,34,46,21,0,5,46,16
1636908,108,26,1905,9,male,380,51,27,46,6,45,3,1,3
1139107,63,11,1950,3,male,226,51,35,46,22,46,10,0,12
1629943,53,3,1960,4,female,268,50,24,47,69,47,13,0,56
1546720,15,27,1998,1,female,171,51,12,47,78,47,47,0,31
2005946,46,13,1967,7,male,160,51,43,48,15,1,4,47,11
1750772,80,20,1933,5,female,368,50,44,48,16,0,2,48,14
1150831,108,24,1905,9,female,584,50,29,48,19,24,7,24,12
1011949,23,8,1990,5,male,437,51,25,49,29,22,10,27,19
2037000,18,23,1995,10,male,363,51,32,49,31,11,18,38,13
2031512,67,28,1946,10,male,92,50,37,48,20,47,15,1,5
1609281,45,9,1968,8,female,628,50,20,48,3,48,3,0,0
1164793,14,9,1999,3,male,440,50,37,48,2,48,2,0,0
1397233,23,7,1990,10,male,361,50,36,48,11,48,9,0,2
1361832,24,4,1989,10,male,360,50,12,48,145,48,107,0,38
1358084,18,19,1995,8,female,390,50,41,50,20,0,15,50,5
2105454,41,16,1972,3,female,217,51,28,53,19,0,4,53,15
1905761,19,30,1994,11,male,320,51,25,53,20,0,7,53,13
1579894,35,16,1978,1,female,449,51,34,53,22,24,13,29,9
1373856,56,17,1957,7,female,520,51,17,53,1,53,1,0,0
1984220,69,13,1944,3,male,298,50,34,54,2,12,1,42,1
1041321,26,1,1987,3,male,323,51,41,54,1,52,1,2,0
1747651,21,3,1992,11,female,194,50,33,55,2,55,2,0,0
1537453,33,30,1980,6,female,233,50,31,55,146,55,113,0,33
2123227,21,23,1992,12,male,135,50,27,57,6,0,5,57,1
1386185,54,9,1959,7,male,342,51,22,56,10,0,0,56,10
1999053,70,4,1943,1,male,847,51,34,57,11,0,0,57,11
2114253,52,27,1961,11,male,86,50,32,56,26,32,15,24,11
1144173,23,25,1990,1,female,2300,50,18,58,56,49,31,9,25
1750936,23,10,1990,1,female,344,50,27,57,110,51,75,6,35
1244914,35,1,1978,3,female,599,50,32,56,3,56,2,0,1
1168222,55,22,1958,3,female,120,51,35,58,31,58,28,0,3
1224884,65,17,1948,1,female,1343,51,32,60,17,0,8,60,9
2028840,35,10,1978,2,male,711,50,32,59,101,0,51,59,50
1377509,58,10,1955,9,male,859,50,43,60,4,60,4,0,0
1738677,63,18,1950,10,female,133,51,45,60,28,60,24,0,4
1344111,60,14,1953,4,male,189,51,31,59,13,59,12,0,1
2109674,74,1,1939,4,female,674,50,24,59,81,59,50,0,31
1957812,29,24,1984,10,female,140,50,29,61,7,0,2,61,5
1809053,46,27,1967,9,male,209,50,30,63,6,0,0,63,6
1560561,23,29,1990,11,female,502,50,21,62,67,53,41,9,26
1874371,54,23,1959,11,female,296,51,12,62,69,62,61,0,8
1202042,25,14,1988,9,male,641,50,17,61,55,61,35,0,20
2048367,73,14,1940,12,female,416,50,33,64,43,0,12,64,31
1959431,60,10,1953,12,female,150,51,41,65,127,50,28,15,99
1507755,32,10,1981,3,male,648,50,24,67,3,1,2,66,1
1873702,38,15,1975,5,male,851,50,15,68,15,26,6,42,9
1823020,59,25,1954,4,male,1235,51,36,67,95,38,50,29,45
1997438,38,31,1975,12,male,219,51,32,67,90,58,71,9,19
1523219,64,13,1949,11,female,292,50,40,69,45,27,20,42,25
1107685,25,21,1988,12,female,606,51,31,70,2,65,1,5,1
2161619,40,22,1973,2,male,1585,50,28,70,4,67,3,3,1
1917003,61,25,1952,5,female,107,50,36,71,23,71,23,0,0
2077765,31,12,1982,2,male,556,50,25,71,19,71,18,0,1
1678721,44,14,1969,10,male,644,51,40,69,179,69,157,0,22
1834845,49,24,1964,9,female,1483,51,16,73,114,1,84,72,30
1961992,71,19,1942,5,male,288,50,37,74,7,69,4,5,3
1438997,23,1,1990,6,male,193,50,38,72,4,72,3,0,1
1050813,25,16,1988,9,female,466,51,21,73,87,73,78,0,9
1240129,43,4,1970,8,female,339,51,21,73,58,73,44,0,14
2099550,33,1,1980,10,male,53,51,51,75,5,0,3,75,2
1984411,108,10,1905,9,male,776,51,7,75,64,0,23,75,41
1713279,14,28,1999,11,female,524,51,26,75,244,1,37,74,207
1313714,27,15,1986,7,male,663,51,48,75,8,25,2,50,6
1651465,63,9,1950,12,female,202,50,35,75,102,41,18,34,84
1355129,41,1,1972,6,male,354,51,33,76,0,76,0,0,0
1675985,52,5,1961,1,male,28,50,48,75,27,75,24,0,3
1059777,108,11,1905,5,female,415,50,39,79,65,12,22,67,43
1035890,25,7,1988,1,male,1298,50,10,80,30,23,9,57,21
2131014,50,9,1963,3,female,163,51,41,80,11,80,10,0,1
1285180,27,14,1986,7,female,195,50,40,79,30,79,27,0,3
2087740,42,9,1971,6,female,612,51,13,78,71,78,67,0,4
1266506,53,15,1960,12,female,715,50,16,81,22,45,9,36,13
1527013,73,23,1940,4,male,378,50,21,83,61,20,14,63,47
1406181,96,12,1917,12,male,278,51,37,82,41,82,37,0,4
1040725,43,3,1970,7,female,344,50,37,84,89,84,79,0,10
1599238,76,10,1937,7,female,519,50,44,85,5,0,0,85,5
1094220,36,1,1977,8,male,300,50,13,86,8,86,6,0,2
1313934,108,17,1905,9,male,34,51,45,86,5,86,3,0,2
1420075,34,16,1979,12,female,1638,51,26,87,19,87,11,0,8
1031909,52,1,1961,2,female,94,51,36,86,298,86,237,0,61
2129582,108,28,1905,12,female,935,50,23,91,58,0,20,91,38
1764161,13,14,2000,1,male,46,50,39,89,53,25,7,64,46
1919952,49,18,1964,10,female,637,50,29,91,86,29,54,62,32
1579531,50,17,1963,12,female,210,50,37,91,14,91,12,0,2
1564675,101,10,1912,7,female,203,50,28,95,1,0,0,95,1
1582542,25,5,1988,8,female,1295,50,20,93,63,34,28,59,35
1071441,48,30,1965,2,female,890,50,32,95,49,71,25,24,24
1141505,53,29,1960,9,female,851,50,26,94,39,78,33,16,6
1700102,15,26,1998,5,male,288,51,31,92,2,92,0,0,2
1965117,26,19,1987,10,female,594,50,34,94,9,94,3,0,6
1575835,29,3,1984,9,male,155,50,44,94,27,94,21,0,6
1114246,74,14,1939,7,female,397,50,34,99,68,96,44,3,24
1200896,100,1,1913,12,female,300,50,38,99,50,99,48,0,2
1173729,52,13,1961,11,female,306,50,32,98,122,98,79,0,43
1895750,63,11,1950,8,female,125,50,43,99,106,99,99,0,7
1444398,37,10,1976,9,female,78,51,42,101,14,0,9,101,5
1051889,37,2,1976,12,female,595,51,22,104,61,0,37,104,24
1470104,39,16,1974,6,female,85,50,37,101,62,0,13,101,49
2077861,22,2,1991,9,female,352,50,29,100,299,100,227,0,72
2035399,38,12,1975,10,female,460,51,31,101,279,101,135,0,144
1713127,67,5,1946,5,female,51,50,31,107,79,9,26,98,53
1665783,31,1,1982,8,female,45,50,29,106,69,27,10,79,59
2178422,36,15,1977,5,female,1272,50,14,107,31,98,25,9,6
1132777,18,4,1995,9,female,37,51,42,106,95,106,57,0,38
1359685,108,6,1905,9,male,380,50,14,105,82,105,59,0,23
1604767,17,9,1996,3,female,571,50,5,113,23,0,4,113,19
2060881,33,28,1980,11,female,141,51,40,111,1,111,0,0,1
1359628,28,1,1985,8,male,446,50,32,118,5,46,4,72,1
1108657,31,13,1982,4,male,187,51,14,114,57,113,42,1,15
1534853,54,7,1959,7,male,148,50,33,114,102,114,68,0,34
1122444,16,25,1997,9,male,389,50,35,114,198,114,87,0,111
1956528,63,21,1950,7,female,144,51,38,123,138,0,7,123,131
1353907,40,15,1973,3,male,453,50,28,124,29,124,26,0,3
1583860,39,19,1974,9,female,295,51,32,120,48,120,40,0,8
1489024,17,2,1996,7,female,149,51,28,121,78,121,60,0,18
1269391,68,14,1945,9,male,478,51,25,129,29,0,1,129,28
1614032,32,8,1981,12,female,304,51,34,128,59,0,51,128,8
2017031,20,9,1993,3,male,247,50,25,130,63,68,32,62,31
1687081,67,27,1946,3,female,518,50,27,125,42,70,30,55,12
1387718,63,12,1950,10,female,420,50,45,126,25,123,12,3,13
1923988,108,1,1905,8,female,152,51,34,126,62,94,28,32,34
1737731,17,1,1996,1,female,431,50,22,127,127,118,40,9,87
1468710,63,27,1950,4,female,12,51,30,128,114,126,76,2,38
1507052,51,13,1962,12,male,2409,51,27,125,27,124,16,1,11
1977246,71,11,1942,9,male,923,50,35,125,74,125,29,0,45
1955862,24,3,1989,2,female,273,51,32,128,139,128,113,0,26
2099766,62,31,1951,12,male,585,51,31,125,170,125,137,0,33
1344578,52,14,1961,4,female,508,51,26,132,12,0,2,132,10
1355085,31,22,1982,6,male,522,50,42,136,3,0,2,136,1
2076172,17,21,1996,3,male,414,51,35,135,36,126,27,9,9
2111706,100,10,1913,5,male,203,51,37,135,25,122,6,13,19
2119141,26,14,1987,5,female,1031,50,21,131,116,113,85,18,31
1890100,14,10,1999,2,male,172,51,44,136,2,136,1,0,1
2168716,16,1,1997,1,male,248,51,26,133,22,133,9,0,13
1233900,23,3,1990,7,female,1474,51,34,131,64,131,48,0,16
1587493,37,27,1976,11,female,586,50,15,139,14,0,0,139,14
1819150,42,10,1971,7,male,670,50,34,142,21,129,11,13,10
1141979,65,14,1948,12,male,196,51,49,143,13,143,3,0,10
1067425,23,15,1990,11,male,292,50,31,138,30,138,26,0,4
1587113,22,1,1991,3,female,192,50,15,143,135,143,94,0,41
1724032,52,12,1961,6,female,384,51,42,146,15,0,4,146,11
1272875,68,30,1945,1,male,556,50,29,149,40,11,19,138,21
1243578,27,13,1986,3,male,502,51,49,145,24,145,20,0,4
2131050,31,21,1982,4,female,1268,51,37,146,0,146,0,0,0
1410654,36,9,1977,11,male,554,50,35,146,45,146,44,0,1
1968345,74,17,1939,8,female,188,50,22,144,38,144,24,0,14
1786911,29,15,1984,3,female,467,51,27,152,48,150,6,2,42
1248608,33,11,1980,10,male,456,50,14,156,88,156,85,0,3
1537335,54,4,1959,5,male,280,50,45,164,2,0,1,164,1
1145284,77,4,1936,4,female,496,51,41,162,159,93,84,69,75
1182110,22,28,1991,10,female,1748,50,32,158,158,33,59,125,99
2116295,27,6,1986,4,male,126,50,30,160,11,160,2,0,9
2045521,37,28,1976,11,male,63,51,45,168,77,78,51,90,26
2140774,48,23,1965,12,male,107,51,48,165,151,138,57,27,94
1306837,90,9,1923,4,male,481,51,26,172,148,171,140,1,8
2009230,63,18,1950,3,female,138,51,21,171,980,170,238,1,742
1054327,37,14,1976,5,male,397,51,40,174,12,4,0,170,12
1149823,26,14,1987,1,female,290,50,28,178,77,0,50,178,27
1498023,30,8,1983,11,female,1497,51,37,176,213,129,135,47,78
1118642,20,3,1993,10,male,65,50,46,175,49,174,31,1,18
1969766,21,1,1992,2,female,254,50,24,176,74,176,30,0,44
1567376,42,7,1971,5,female,143,50,46,175,213,175,166,0,47
1988966,57,6,1956,1,female,230,51,28,179,113,179,94,0,19
1823804,35,26,1978,10,female,236,51,40,189,35,0,14,189,21
1560835,32,10,1981,9,female,183,51,33,184,11,184,3,0,8
1159199,42,13,1971,6,female,61,50,44,189,140,189,74,0,66
1037650,38,15,1975,1,female,221,50,40,200,25,0,10,200,15
1209552,53,7,1960,4,male,1571,51,19,191,24,149,15,42,9
1349080,41,25,1972,1,female,875,51,31,199,6,199,3,0,3
2095369,31,29,1982,5,female,1769,51,11,200,81,200,59,0,22
1307533,60,27,1953,10,female,225,51,46,191,96,191,61,0,35
2131583,19,18,1994,12,male,203,50,44,201,228,13,25,188,203
1208186,61,28,1952,2,female,2025,50,8,202,35,101,17,101,18
1665345,71,3,1942,7,male,401,51,17,201,18,201,15,0,3
1631567,39,8,1974,2,female,1860,51,32,208,30,208,15,0,15
1737427,74,5,1939,6,female,29,51,38,202,218,202,135,0,83
2066682,18,1,1995,2,female,1267,51,17,221,52,216,17,5,35
1694321,51,2,1962,8,female,1513,51,26,225,84,0,55,225,29
1624752,19,2,1994,12,male,335,51,44,230,15,220,7,10,8
1043850,63,19,1950,9,male,1006,51,14,223,145,221,80,2,65
1155444,46,29,1967,1,male,365,50,38,222,34,222,34,0,0
1442413,53,17,1960,11,female,179,51,38,227,42,227,39,0,3
2061783,56,16,1957,12,female,63,50,36,230,116,230,76,0,40
1773686,27,22,1986,4,male,537,50,33,242,100,0,58,242,42
1804784,45,4,1968,6,male,1444,50,21,242,48,66,23,176,25
1901718,20,27,1993,12,female,814,51,32,242,278,219,215,23,63
1519958,68,14,1945,12,female,1283,51,19,241,140,239,91,2,49
1413686,39,1,1974,3,female,59,51,38,235,84,234,54,1,30
1198314,28,21,1985,9,female,176,51,34,234,30,234,16,0,14
1540755,36,13,1977,3,female,586,51,41,236,115,236,18,0,97
1033765,74,24,1939,8,female,671,50,35,250,41,249,16,1,25
2004268,25,19,1988,5,male,261,51,27,257,91,257,83,0,8
1146335,41,17,1972,12,female,1361,50,24,270,470,135,359,135,111
2112642,23,3,1990,9,female,115,50,38,263,161,263,134,0,27
1297044,46,20,1967,1,female,301,50,36,288,67,186,23,102,44
1792530,17,9,1996,1,female,373,51,44,291,43,272,43,19,0
1202215,18,18,1995,10,male,440,51,16,292,38,292,31,0,7
2006643,59,12,1954,9,female,799,51,40,277,34,277,14,0,20
1062158,34,27,1979,4,female,649,50,27,280,482,280,401,0,81
1229864,66,23,1947,2,female,1027,50,15,299,46,299,29,0,17
1945937,52,13,1961,4,male,498,50,36,308,76,308,62,0,14
1462593,66,20,1947,5,female,636,50,36,320,14,0,4,320,10
1817382,69,17,1944,5,male,293,51,40,317,12,317,6,0,6
1323518,21,2,1992,5,female,211,51,33,311,70,311,18,0,52
1652243,42,5,1971,1,female,27,51,50,333,128,52,72,281,56
2150879,38,18,1975,6,female,2110,51,29,336,87,0,23,336,64
1575155,69,24,1944,11,male,1247,51,29,337,206,152,142,185,64
1970159,30,30,1983,1,female,393,50,38,336,145,333,72,3,73
1285334,61,29,1952,10,female,222,50,38,346,84,346,65,0,19
1605643,54,20,1959,6,female,78,50,33,356,95,1,17,355,78
1578818,21,25,1992,10,female,607,50,29,363,154,276,71,87,83
1268915,58,13,1955,6,female,170,50,24,352,23,352,16,0,7
1076588,22,4,1991,7,female,478,51,27,385,82,0,37,385,45
1478888,41,28,1972,10,female,641,51,38,374,172,157,80,217,92
1729548,21,4,1992,1,male,612,50,35,376,24,376,11,0,13
1568680,52,25,1961,2,female,1050,51,39,377,40,377,28,0,12
1202337,26,20,1987,4,female,497,51,20,411,147,14,40,397,107
1172167,26,28,1987,6,male,1422,50,23,396,75,172,56,224,19
1007585,53,6,1960,11,female,643,50,26,400,295,82,104,318,191
2009259,74,1,1939,3,female,384,50,36,396,374,372,209,24,165
1972968,24,6,1989,11,female,466,51,39,402,146,401,90,1,56
1100628,37,4,1976,5,female,714,50,31,429,237,0,13,429,224
1353697,37,22,1976,6,female,76,50,38,447,168,244,78,203,90
1815118,61,21,1952,2,female,30,51,45,426,118,426,96,0,22
1439921,19,14,1994,8,female,713,51,34,474,339,0,114,474,225
1986609,47,18,1966,1,female,71,51,36,477,43,477,29,0,14
2135959,29,22,1984,7,female,155,50,17,456,117,456,43,0,74
2083965,20,28,1993,1,female,214,50,32,515,700,0,57,515,643
2079300,33,20,1980,5,female,476,50,22,518,85,493,60,25,25
1186150,63,4,1950,4,female,1577,50,26,499,196,483,144,16,52
1774066,57,14,1956,6,female,1926,50,18,516,297,496,268,20,29
1560218,62,28,1951,7,female,173,50,34,503,166,503,108,0,58
1933166,23,6,1990,5,female,107,51,27,526,25,468,13,58,12
1801506,39,6,1974,3,female,77,50,36,558,360,558,267,0,93
1727956,28,1,1985,6,female,823,51,40,604,314,604,87,0,227
1698407,16,1,1997,2,male,144,50,31,600,145,600,135,0,10
1372450,23,2,1990,9,female,390,51,38,616,104,0,15,616,89
1529912,27,12,1986,6,female,150,50,20,693,211,285,23,408,188
2118131,65,25,1948,5,female,295,50,44,731,478,0,165,731,313
1436909,51,10,1962,2,female,162,51,25,731,98,729,70,2,28
1040179,56,20,1957,6,female,170,50,22,814,176,814,128,0,48
2113339,17,21,1996,6,male,1777,51,19,889,381,683,301,206,80
1839871,36,21,1977,9,male,315,51,37,978,13,978,12,0,1
1639355,25,15,1988,7,female,318,50,32,935,513,935,381,0,132
1715648,22,1,1991,12,female,80,51,19,1071,53,1071,31,0,22
2044456,50,15,1963,10,female,206,51,23,1172,351,0,96,1172,255
1045473,54,2,1959,2,female,421,50,8,1181,247,0,49,1181,198
1194969,14,16,1999,2,female,418,51,20,1284,226,1258,157,26,69
1987572,18,28,1995,5,female,644,51,26,1273,1855,924,1199,349,656
1596757,43,3,1970,6,female,802,50,34,1174,2,1165,2,9,0
1403446,23,11,1990,1,male,239,51,33,1157,109,1157,94,0,15
1581964,14,14,1999,11,female,311,51,18,1323,163,0,11,1323,152
1453647,31,17,1982,8,female,707,50,32,1980,873,1410,406,570,467
1616838,57,21,1956,3,female,347,50,26,2293,183,2293,91,0,92
1431539,46,5,1967,12,female,288,51,30,2820,61,0,12,2820,49
1373571,39,9,1974,3,female,544,51,43,3502,178,2968,139,534,39
2070079,25,11,1988,12,male,60,53,43,0,0,0,0,0,0
1806013,41,18,1972,2,male,173,52,46,0,0,0,0,0,0
1766089,74,3,1939,5,male,168,53,30,0,0,0,0,0,0
1061300,40,16,1973,7,female,199,52,8,0,32,0,11,0,21
1616437,56,2,1957,9,male,398,53,35,0,1,0,1,0,0
1308588,67,10,1946,9,male,34,52,50,0,0,0,0,0,0
1457691,23,14,1990,10,male,213,53,41,0,0,0,0,0,0
2021539,26,4,1987,11,male,676,53,38,0,0,0,0,0,0
1768661,55,22,1958,12,male,289,52,25,0,0,0,0,0,0
1004820,58,7,1955,1,male,286,52,35,0,1,0,1,0,0
1966262,55,2,1958,2,female,520,53,26,0,0,0,0,0,0
1726320,55,14,1958,3,female,680,53,51,0,1,0,0,0,1
1449823,43,10,1970,3,male,311,53,31,0,0,0,0,0,0
1980413,103,23,1910,3,male,60,52,43,0,13,0,9,0,4
1860548,57,12,1956,6,male,413,52,49,0,67,0,20,0,47
1066996,52,26,1961,10,male,293,53,34,0,0,0,0,0,0
1149329,55,12,1958,10,female,37,52,33,0,2,0,2,0,0
1790778,48,25,1965,1,male,34,53,50,0,0,0,0,0,0
1269705,53,25,1960,3,male,433,53,39,0,0,0,0,0,0
1547652,102,5,1911,8,male,149,52,35,0,0,0,0,0,0
1660401,29,14,1984,10,female,569,53,32,0,0,0,0,0,0
1561404,59,9,1954,12,male,506,53,24,0,0,0,0,0,0
2120380,21,15,1992,4,female,412,53,29,0,0,0,0,0,0
1254244,70,15,1943,4,female,208,52,19,0,0,0,0,0,0
2115341,58,9,1955,4,female,219,53,15,0,0,0,0,0,0
1973524,52,12,1961,5,male,385,52,43,0,0,0,0,0,0
1793131,57,8,1956,5,male,155,52,45,0,5,0,3,0,2
1331569,30,16,1983,11,male,347,53,35,0,6,0,2,0,4
2000887,54,26,1959,12,male,490,52,43,0,0,0,0,0,0
1747327,30,11,1983,1,male,449,52,42,0,2,0,2,0,0
1646200,45,13,1968,1,male,188,52,31,0,0,0,0,0,0
1573778,47,8,1966,1,male,67,53,44,0,0,0,0,0,0
1104501,27,15,1986,3,female,340,52,36,0,0,0,0,0,0
2149408,17,1,1996,4,male,507,52,47,0,8,0,3,0,5
1055699,13,17,2000,4,male,214,53,13,0,2,0,1,0,1
1369860,27,3,1986,6,male,193,53,31,0,0,0,0,0,0
1482859,54,20,1959,7,female,257,53,21,0,1,0,1,0,0
1866382,43,16,1970,11,male,753,53,25,0,0,0,0,0,0
1491055,53,22,1960,1,male,367,53,30,0,0,0,0,0,0
1723826,32,28,1981,1,female,138,53,40,0,0,0,0,0,0
1778613,62,31,1951,2,male,472,52,35,0,1,0,1,0,0
1440865,100,5,1913,3,male,470,53,34,0,0,0,0,0,0
1337537,51,30,1962,4,male,422,52,43,0,0,0,0,0,0
1064941,63,10,1950,4,male,329,53,42,0,1,0,1,0,0
1583464,66,4,1947,6,female,618,53,25,0,0,0,0,0,0
1231747,51,18,1962,8,male,187,53,34,0,2,0,2,0,0
1801516,53,21,1960,8,male,163,52,42,0,0,0,0,0,0
1542434,36,9,1977,9,male,346,52,34,0,1,0,1,0,0
1427403,58,24,1955,11,female,475,52,28,0,3,0,3,0,0
1385243,58,27,1955,2,male,159,52,42,0,0,0,0,0,0
2166698,63,8,1950,4,male,372,52,35,0,0,0,0,0,0
2096230,76,3,1937,5,male,154,52,49,0,0,0,0,0,0
2025044,103,17,1910,5,male,155,52,42,0,13,0,8,0,5
1038964,60,5,1953,6,male,256,52,22,0,1,0,1,0,0
1169853,65,16,1948,6,male,511,53,36,0,1,0,0,0,1
1343977,63,11,1950,6,male,207,52,45,0,0,0,0,0,0
2137514,54,17,1959,8,male,415,52,4,0,0,0,0,0,0
1667357,47,1,1966,9,male,161,52,52,0,0,0,0,0,0
1698219,23,15,1990,10,female,1305,53,27,0,0,0,0,0,0
1403678,46,14,1967,10,male,511,53,30,0,7,0,4,0,3
1217430,69,12,1944,10,female,359,52,2,0,0,0,0,0,0
1459180,30,10,1983,10,male,150,53,53,0,11,0,10,0,1
1043141,17,5,1996,1,male,333,52,22,0,0,0,0,0,0
1231880,67,7,1946,1,male,33,52,43,0,0,0,0,0,0
1387883,68,20,1945,4,female,356,53,26,0,0,0,0,0,0
1136483,58,4,1955,4,female,290,52,43,0,0,0,0,0,0
1955880,34,1,1979,8,male,367,52,37,0,1,0,0,0,1
2191231,24,16,1989,8,male,208,53,19,0,0,0,0,0,0
1390654,44,4,1969,9,male,571,52,47,0,0,0,0,0,0
1208677,54,29,1959,10,male,580,53,50,0,6,0,1,0,5
1800075,48,27,1965,10,male,273,52,32,0,0,0,0,0,0
2013086,108,22,1905,7,male,635,52,36,0,0,0,0,0,0
1342411,48,6,1965,7,male,162,53,40,0,6,0,1,0,5
1045703,52,3,1961,8,male,674,53,41,0,0,0,0,0,0
1427457,62,14,1951,12,male,232,52,38,0,0,0,0,0,0
1890118,45,11,1968,1,male,350,53,32,0,0,0,0,0,0
1460519,57,26,1956,3,male,264,52,43,0,14,0,14,0,0
1327779,49,22,1964,5,female,223,53,30,0,0,0,0,0,0
1255545,42,12,1971,7,male,206,52,27,0,8,0,4,0,4
1378841,57,2,1956,8,male,687,52,35,0,0,0,0,0,0
1532433,48,25,1965,8,male,486,53,37,0,0,0,0,0,0
2038291,18,14,1995,10,male,123,53,39,0,0,0,0,0,0
1558263,41,8,1972,12,male,219,53,28,0,0,0,0,0,0
1055853,55,18,1958,2,female,544,53,14,0,4,0,0,0,4
1437821,63,29,1950,3,male,271,53,46,0,2,0,2,0,0
1622729,86,14,1927,4,male,750,52,43,0,4,0,4,0,0
1241072,22,7,1991,4,male,452,52,32,0,0,0,0,0,0
1765793,39,28,1974,4,male,394,52,41,0,1,0,0,0,1
1891225,75,1,1938,5,male,325,53,47,0,0,0,0,0,0
1892256,56,1,1957,12,female,605,53,28,0,1,0,0,0,1
1501464,47,5,1966,1,male,130,52,20,0,0,0,0,0,0
1311965,19,15,1994,1,male,138,53,44,0,0,0,0,0,0
1564531,52,14,1961,6,male,269,53,16,0,0,0,0,0,0
1703637,49,31,1964,6,male,36,52,51,0,0,0,0,0,0
1891148,36,19,1977,8,male,396,53,34,0,2,0,2,0,0
1828343,14,26,1999,8,male,202,53,28,0,0,0,0,0,0
1709832,14,24,1999,9,male,386,52,38,0,0,0,0,0,0
2123148,14,16,1999,10,male,183,53,45,0,7,0,7,0,0
1651813,14,15,1999,1,male,369,53,51,0,26,0,1,0,25
1130430,14,6,1999,1,male,346,52,34,0,0,0,0,0,0
1978088,14,18,1999,1,male,40,52,24,0,1,0,1,0,0
1224594,14,9,1999,2,male,487,53,12,0,1,0,0,0,1
1417300,16,17,1997,3,male,366,52,48,0,0,0,0,0,0
1507844,16,29,1997,3,female,255,52,42,0,0,0,0,0,0
1879490,15,5,1998,5,male,290,52,28,0,1,0,1,0,0
2054683,15,8,1998,7,male,524,53,44,0,1,0,0,0,1
2189765,15,9,1998,7,male,269,53,30,0,0,0,0,0,0
1702961,15,13,1998,11,female,366,52,19,0,0,0,0,0,0
1029971,15,18,1998,12,male,790,52,44,0,0,0,0,0,0
1867325,15,7,1998,3,male,684,52,38,0,3,0,0,0,3
1656255,15,6,1998,6,male,433,52,40,0,0,0,0,0,0
1857245,15,31,1998,6,male,91,52,28,0,1,0,0,0,1
2043330,16,12,1997,9,male,369,53,36,0,1,0,1,0,0
2106326,16,17,1997,2,male,221,53,34,0,3,0,2,0,1
1765396,16,22,1997,3,male,304,52,44,0,0,0,0,0,0
1380232,16,19,1997,1,male,196,52,20,0,0,0,0,0,0
2049940,18,9,1995,3,male,240,53,50,0,1,0,0,0,1
1425545,17,16,1996,5,male,263,53,12,0,4,0,4,0,0
1401397,17,17,1996,9,male,195,52,46,0,0,0,0,0,0
1783191,17,1,1996,12,female,540,52,25,0,0,0,0,0,0
1741370,17,31,1996,12,male,234,52,43,0,0,0,0,0,0
1610841,17,22,1996,2,male,214,52,49,0,0,0,0,0,0
2078103,19,19,1994,6,male,788,53,14,0,2,0,1,0,1
2082116,19,12,1994,7,male,480,52,21,0,0,0,0,0,0
1923100,18,11,1995,7,female,284,53,33,0,2,0,1,0,1
1710844,18,1,1995,1,male,1518,52,32,0,1,0,1,0,0
1398230,18,1,1995,1,female,423,53,32,0,0,0,0,0,0
1730367,18,15,1995,1,female,361,52,25,0,3,0,1,0,2
2048568,18,22,1995,6,male,431,53,49,0,8,0,7,0,1
2187809,18,28,1995,8,female,306,53,40,0,0,0,0,0,0
1236049,18,6,1995,9,male,351,52,41,0,0,0,0,0,0
1558036,18,25,1995,12,male,107,52,40,0,0,0,0,0,0
1499680,20,12,1993,3,male,181,53,38,0,0,0,0,0,0
1533160,19,30,1994,3,male,131,52,43,0,1,0,1,0,0
2112029,19,2,1994,5,female,592,52,21,0,1,0,1,0,0
1266690,19,17,1994,4,female,389,53,50,0,0,0,0,0,0
1851788,19,1,1994,7,male,565,52,27,0,0,0,0,0,0
1637821,19,23,1994,7,male,416,52,29,0,0,0,0,0,0
1674996,19,30,1994,9,female,497,53,46,0,1,0,1,0,0
1657578,19,1,1994,12,female,112,53,17,0,0,0,0,0,0
1409494,19,11,1994,3,male,232,53,41,0,0,0,0,0,0
1811798,19,6,1994,5,male,325,53,26,0,1,0,0,0,1
2149703,19,14,1994,8,male,148,52,40,0,0,0,0,0,0
2167766,21,30,1992,10,female,381,53,23,0,0,0,0,0,0
1498723,20,5,1993,10,male,310,52,23,0,0,0,0,0,0
2142187,20,2,1993,12,male,452,53,21,0,1,0,1,0,0
1314022,20,8,1993,11,male,543,52,41,0,0,0,0,0,0
2081090,20,15,1993,1,male,120,53,39,0,0,0,0,0,0
1927088,20,14,1993,2,male,736,53,37,0,16,0,13,0,3
1855698,20,1,1993,8,male,813,52,35,0,0,0,0,0,0
1160949,20,1,1993,9,male,267,52,14,0,0,0,0,0,0
1967975,20,22,1993,12,male,433,52,49,0,0,0,0,0,0
1608213,20,17,1993,3,male,515,52,45,0,0,0,0,0,0
1881146,20,24,1993,8,male,316,53,32,0,22,0,0,0,22
1767243,20,15,1993,5,male,331,52,15,0,0,0,0,0,0
1735172,20,17,1993,9,male,316,53,28,0,0,0,0,0,0
1942126,20,17,1993,7,male,1026,53,17,0,0,0,0,0,0
1086690,21,3,1992,7,male,605,52,34,0,0,0,0,0,0
1660443,21,1,1992,10,male,272,52,49,0,0,0,0,0,0
2103996,21,3,1992,11,male,89,53,33,0,1,0,1,0,0
1333577,21,4,1992,2,male,300,52,47,0,0,0,0,0,0
1142025,21,26,1992,3,male,1700,52,12,0,0,0,0,0,0
1060973,21,8,1992,11,male,345,53,23,0,0,0,0,0,0
1297569,21,3,1992,6,male,1472,52,7,0,3,0,3,0,0
1365182,21,30,1992,10,male,609,53,42,0,0,0,0,0,0
1222579,21,27,1992,7,female,894,53,32,0,0,0,0,0,0
2159801,22,15,1991,2,female,853,52,20,0,1,0,0,0,1
1250740,22,29,1991,4,male,486,53,43,0,0,0,0,0,0
1436536,22,18,1991,8,male,339,53,32,0,3,0,3,0,0
1523607,24,8,1989,9,male,656,52,16,0,0,0,0,0,0
1687588,23,1,1990,4,female,598,53,22,0,4,0,3,0,1
2100728,23,17,1990,8,female,939,52,41,0,2,0,0,0,2
1286657,23,1,1990,8,male,241,52,42,0,3,0,2,0,1
1177388,23,5,1990,9,male,632,52,32,0,0,0,0,0,0
1075697,23,14,1990,9,female,585,52,40,0,0,0,0,0,0
2026264,23,14,1990,5,female,1176,52,33,0,0,0,0,0,0
1842950,23,20,1990,5,male,1871,52,21,0,4,0,0,0,4
1272126,25,11,1988,8,male,679,52,37,0,0,0,0,0,0
1163690,24,13,1989,8,male,978,52,22,0,0,0,0,0,0
1442379,24,10,1989,12,female,738,53,46,0,1,0,0,0,1
1449252,24,11,1989,5,male,807,53,13,0,1,0,0,0,1
2068096,24,18,1989,9,female,500,52,29,0,3,0,0,0,3
1582465,24,2,1989,10,male,741,52,4,0,1,0,0,0,1
1761627,24,3,1989,2,female,419,52,33,0,1,0,1,0,0
1596698,26,17,1987,7,female,896,53,27,0,2,0,1,0,1
1289657,25,6,1988,7,male,560,53,47,0,0,0,0,0,0
1007621,25,1,1988,8,male,1048,52,20,0,0,0,0,0,0
1422912,25,12,1988,3,female,583,52,43,0,0,0,0,0,0
1550472,25,7,1988,7,male,1261,52,25,0,1,0,1,0,0
1690999,25,17,1988,1,male,1113,52,25,0,0,0,0,0,0
1265348,25,8,1988,5,male,1033,53,35,0,0,0,0,0,0
2119490,25,20,1988,7,male,726,53,20,0,0,0,0,0,0
1797404,25,31,1988,12,male,441,52,31,0,1,0,1,0,0
1956427,26,1,1987,1,male,429,53,28,0,3,0,0,0,3
1556242,26,1,1987,4,male,1552,52,15,0,0,0,0,0,0
1394272,26,1,1987,10,female,221,52,47,0,0,0,0,0,0
1737388,26,11,1987,8,male,667,52,46,0,0,0,0,0,0
1873636,26,19,1987,6,male,1834,52,15,0,0,0,0,0,0
2119418,26,2,1987,11,male,1673,53,28,0,3,0,0,0,3
1187001,26,27,1987,11,male,1856,52,4,0,1,0,0,0,1
1901217,26,16,1987,8,female,18,52,50,0,2,0,2,0,0
1800360,26,24,1987,12,female,800,53,22,0,0,0,0,0,0
1138719,28,3,1985,3,female,122,53,30,0,2,0,2,0,0
1363669,28,2,1985,12,female,974,52,39,0,2,0,2,0,0
1460998,27,15,1986,2,male,1770,53,18,0,1,0,0,0,1
1782520,27,6,1986,5,male,1540,52,17,0,0,0,0,0,0
1678614,27,1,1986,5,male,1776,52,11,0,0,0,0,0,0
1503199,27,20,1986,8,female,667,52,26,0,1,0,1,0,0
2090132,28,1,1985,8,female,179,52,21,0,0,0,0,0,0
1863423,28,5,1985,2,male,1497,52,25,0,0,0,0,0,0
1176696,29,11,1984,11,male,1751,53,9,0,3,0,2,0,1
1700235,29,2,1984,6,female,1340,53,33,0,0,0,0,0,0
1335460,29,1,1984,7,male,1021,53,27,0,0,0,0,0,0
1841705,29,8,1984,10,female,1967,52,15,0,0,0,0,0,0
1668775,31,14,1982,3,male,607,52,26,0,0,0,0,0,0
2165840,31,6,1982,10,male,1205,53,31,0,0,0,0,0,0
1479678,30,21,1983,9,male,1566,52,25,0,4,0,1,0,3
1584027,30,25,1983,11,female,994,52,36,0,1,0,1,0,0
1738077,30,28,1983,1,male,1666,53,12,0,2,0,2,0,0
1864952,30,20,1983,12,male,560,53,25,0,0,0,0,0,0
1061665,31,29,1982,6,female,1544,53,28,0,1,0,0,0,1
1439335,31,5,1982,8,female,492,52,26,0,0,0,0,0,0
2124103,31,2,1982,8,male,830,53,31,0,8,0,8,0,0
2184684,31,17,1982,5,male,179,52,38,0,0,0,0,0,0
1977857,31,29,1982,1,male,251,53,29,1,0,0,0,1,0
1671288,31,24,1982,5,male,236,53,43,1,0,0,0,1,0
1373482,33,31,1980,6,male,270,52,43,1,0,0,0,1,0
1116977,32,15,1981,6,female,537,53,42,1,0,0,0,1,0
1761832,32,18,1981,4,male,457,52,29,1,0,0,0,1,0
1852162,32,23,1981,1,male,481,53,10,1,0,0,0,1,0
1495190,33,5,1980,5,female,236,52,36,1,0,0,0,1,0
1041473,33,17,1980,9,female,1671,53,31,1,0,0,0,1,0
1786135,33,16,1980,3,female,121,53,45,1,1,0,1,1,0
2056924,33,4,1980,4,male,407,53,47,1,1,0,1,1,0
1725054,35,21,1978,11,male,1081,53,18,1,1,0,0,1,1
1593971,34,11,1979,10,female,121,52,44,1,1,0,1,1,0
1023302,34,28,1979,8,male,725,53,29,1,1,0,0,1,1
1058668,34,20,1979,1,male,1439,53,29,1,1,0,1,1,0
2110018,34,27,1979,3,male,1668,52,19,1,1,0,1,1,0
1176604,35,7,1978,7,male,1095,52,37,1,1,0,0,1,1
1053008,37,1,1976,10,male,413,52,21,1,56,0,14,1,42
1409158,38,11,1975,12,female,381,52,36,1,3,0,0,1,3
2189043,37,2,1976,6,female,682,52,19,1,2,0,1,1,1
1150663,37,21,1976,11,female,500,53,37,1,14,0,5,1,9
1708510,37,11,1976,1,male,575,53,39,1,15,0,7,1,8
2002005,37,8,1976,3,female,385,52,40,1,12,0,9,1,3
2188924,39,8,1974,5,male,176,52,27,1,15,0,8,1,7
2155740,38,6,1975,10,female,875,52,34,1,27,0,13,1,14
2126105,38,29,1975,10,male,1187,52,8,1,5,0,3,1,2
1402440,39,23,1974,4,female,2135,52,27,1,5,0,5,1,0
1385912,39,26,1974,5,male,1212,52,31,1,17,0,1,1,16
1170736,40,26,1973,1,female,1379,52,12,1,3,0,2,1,1
1262039,40,14,1973,6,male,265,53,32,1,0,1,0,0,0
1710207,40,1,1973,12,female,539,53,29,1,0,1,0,0,0
1330610,42,11,1971,11,male,676,52,30,1,0,1,0,0,0
1295425,41,2,1972,2,male,305,52,41,1,0,1,0,0,0
1080655,42,26,1971,1,male,449,53,25,1,0,1,0,0,0
1757642,44,28,1969,7,male,256,52,40,1,0,1,0,0,0
1304232,43,8,1970,7,male,672,52,39,1,0,1,0,0,0
1033872,43,13,1970,8,male,264,53,36,1,0,1,0,0,0
1210002,44,24,1969,12,male,252,53,51,1,0,1,0,0,0
1363627,45,18,1968,1,female,162,52,34,1,0,1,0,0,0
1970131,45,2,1968,5,male,211,53,48,1,0,1,0,0,0
2007783,45,7,1968,8,male,569,53,33,1,0,1,0,0,0
1040767,45,1,1968,9,male,480,53,29,1,0,1,0,0,0
1194653,46,27,1967,7,male,550,52,34,1,0,1,0,0,0
1714715,47,17,1966,2,male,401,52,42,1,0,1,0,0,0
2060420,47,7,1966,12,male,658,52,18,1,0,1,0,0,0
1202843,47,25,1966,9,male,368,52,45,1,0,1,0,0,0
1574581,47,14,1966,11,female,860,53,37,1,0,1,0,0,0
2179617,48,30,1965,1,male,87,52,46,1,1,1,1,0,0
1286849,50,15,1963,4,male,37,53,44,1,1,1,1,0,0
1747604,50,10,1963,4,male,96,53,42,1,1,1,1,0,0
1909749,51,28,1962,4,male,186,52,22,1,1,1,0,0,1
1333257,53,12,1960,6,male,342,52,44,1,1,1,0,0,1
1965599,53,5,1960,2,female,389,53,5,1,1,1,1,0,0
1128841,53,26,1960,11,female,1216,52,20,1,1,1,0,0,1
1917334,53,28,1960,6,male,134,53,37,1,11,1,9,0,2
1811989,54,5,1959,12,male,316,53,29,1,19,1,13,0,6
1029922,54,22,1959,11,male,188,52,47,1,2,1,0,0,2
2103232,54,14,1959,2,male,1182,52,16,1,2,1,1,0,1
1123042,54,14,1959,8,male,387,52,4,1,13,1,7,0,6
1813101,55,27,1958,3,male,630,53,39,1,16,1,9,0,7
1034716,55,26,1958,4,male,261,53,49,1,2,1,2,0,0
1639009,57,3,1956,11,male,717,53,17,1,8,1,4,0,4
1230168,57,20,1956,7,female,567,53,21,1,58,1,15,0,43
1755923,57,10,1956,12,male,500,52,16,1,38,1,20,0,18
1611881,59,7,1954,9,male,49,52,43,1,3,1,2,0,1
1169764,58,8,1955,1,female,223,53,41,1,2,1,1,0,1
1985989,59,12,1954,1,male,577,52,31,1,22,1,21,0,1
1959927,59,7,1954,11,male,414,52,25,1,2,1,2,0,0
1808620,60,23,1953,7,female,319,53,24,1,37,1,20,0,17
1591606,62,10,1951,8,male,1165,52,37,1,36,1,34,0,2
2120853,64,27,1949,10,female,1836,52,15,1,3,1,3,0,0
1289063,64,19,1949,6,male,1110,52,35,1,4,1,3,0,1
1952817,63,25,1950,3,female,1691,53,21,1,7,1,6,0,1
1486467,65,21,1948,3,female,536,53,41,1,2,1,2,0,0
1700033,64,18,1949,2,female,1858,53,37,1,2,1,2,0,0
1010999,67,15,1946,5,male,293,53,28,2,0,0,0,2,0
1795317,66,20,1947,4,male,722,53,16,2,0,0,0,2,0
1359254,67,19,1946,4,male,1082,52,13,2,0,0,0,2,0
1806257,69,13,1944,7,male,492,52,32,2,1,0,1,2,0
1440633,69,13,1944,12,male,621,52,27,2,1,0,0,2,1
1120261,69,18,1944,3,female,566,52,31,2,2,0,0,2,2
1786039,71,12,1942,9,male,401,52,20,2,5,0,2,2,3
1649476,73,24,1940,1,female,154,52,33,2,6,0,0,2,6
2073407,73,12,1940,3,male,43,52,49,2,31,0,10,2,21
2037634,73,31,1940,6,female,1104,52,24,2,32,0,9,2,23
1778606,73,15,1940,9,male,136,53,48,2,0,1,0,1,0
2051286,74,4,1939,8,male,387,52,23,2,0,1,0,1,0
1370925,75,15,1938,11,male,432,53,48,2,0,1,0,1,0
1857797,77,23,1936,11,male,209,53,25,2,8,1,7,1,1
1128880,82,15,1931,2,female,499,53,17,2,73,1,30,1,43
1882336,87,18,1926,3,female,512,52,15,2,17,1,11,1,6
2083575,93,20,1920,11,male,655,53,17,2,3,1,3,1,0
1431908,97,4,1916,1,female,1845,52,11,2,5,1,3,1,2
1474019,101,17,1912,8,male,6,52,44,2,0,2,0,0,0
1509170,103,8,1910,1,male,346,53,40,2,0,2,0,0,0
1968458,108,18,1905,3,male,405,52,24,2,0,2,0,0,0
1917046,13,1,2000,12,male,484,53,26,2,0,2,0,0,0
1019280,15,19,1998,1,male,399,52,37,2,0,2,0,0,0
2052766,18,9,1995,11,male,297,53,44,2,0,2,0,0,0
1338093,23,7,1990,6,male,607,53,17,2,0,2,0,0,0
1990985,27,28,1986,2,female,513,53,24,2,0,2,0,0,0
1433794,31,1,1982,4,male,283,52,14,2,1,2,1,0,0
1631882,42,1,1971,6,male,181,53,47,2,1,2,1,0,0
1762889,69,18,1944,4,male,96,52,24,2,1,2,1,0,0
2034050,21,20,1992,3,female,247,52,47,2,1,2,1,0,0
1578417,28,28,1985,5,female,219,53,45,2,1,2,0,0,1
2029138,57,20,1956,1,male,1081,52,10,2,1,2,1,0,0
1484868,59,11,1954,10,female,419,52,35,2,1,2,1,0,0
1767273,62,13,1951,9,male,1523,52,14,2,1,2,1,0,0
1131544,64,20,1949,7,male,540,53,27,2,2,2,1,0,1
1176516,66,18,1947,6,male,531,53,46,2,2,2,2,0,0
1628959,73,1,1940,3,male,397,52,26,2,2,2,0,0,2
1230371,23,8,1990,5,male,681,53,32,2,2,2,0,0,2
2109467,37,17,1976,12,female,1436,53,19,2,2,2,0,0,2
1910049,43,22,1970,10,female,135,52,24,2,14,2,12,0,2
2185211,55,28,1958,8,female,133,52,35,2,6,2,2,0,4
1299813,54,20,1959,2,female,265,53,40,2,3,2,3,0,0
1795643,55,7,1958,4,male,217,53,37,2,7,2,4,0,3
1862871,55,22,1958,1,female,148,53,44,2,103,2,43,0,60
1314491,56,9,1957,2,female,549,52,41,2,9,2,5,0,4
1130619,65,4,1948,11,female,370,52,28,2,24,2,4,0,20
1298332,70,11,1943,6,female,330,53,14,2,4,2,4,0,0
1634338,70,29,1943,1,male,638,52,27,2,8,2,5,0,3
1984440,86,16,1927,5,male,154,52,34,2,4,2,2,0,2
1748239,15,14,1998,9,male,336,53,47,2,6,2,6,0,0
2060450,18,25,1995,1,male,254,52,38,2,3,2,1,0,2
1229075,19,10,1994,10,male,460,52,24,2,101,2,94,0,7
1822393,19,3,1994,9,male,130,53,37,2,4,2,3,0,1
1727644,21,6,1992,11,female,772,53,6,2,7,2,6,0,1
1152531,23,3,1990,7,male,40,52,41,2,4,2,2,0,2
1550891,23,1,1990,8,male,965,53,30,2,7,2,4,0,3
1625179,24,22,1989,10,male,1549,53,22,2,44,2,15,0,29
1057129,26,3,1987,10,male,441,52,6,2,14,2,9,0,5
2099703,26,2,1987,7,female,1119,52,34,2,12,2,11,0,1
2018089,26,22,1987,2,male,310,52,44,3,0,0,0,3,0
1341018,28,22,1985,2,male,1466,53,21,3,0,0,0,3,0
1826969,29,13,1984,5,female,485,52,38,3,1,0,1,3,0
2037158,30,3,1983,5,female,388,52,33,3,1,0,1,3,0
1491700,33,2,1980,8,male,171,53,46,3,2,0,1,3,1
1185622,42,25,1971,3,female,272,52,34,3,4,0,2,3,2
1923230,53,19,1960,4,male,341,52,32,3,0,1,0,2,0
1537297,60,10,1953,11,male,389,52,29,3,1,1,0,2,1
1726189,19,24,1994,7,male,149,53,50,3,1,1,1,2,0
1858654,21,9,1992,9,male,361,52,33,3,20,2,8,1,12
1524944,22,6,1991,5,female,573,52,21,3,15,1,13,2,2
1554601,23,12,1990,8,female,321,52,34,3,13,1,5,2,8
1783072,27,6,1986,8,male,931,52,32,3,76,2,30,1,46
1713137,31,1,1982,7,male,461,52,36,3,0,3,0,0,0
1261369,67,29,1946,10,male,96,53,35,3,0,3,0,0,0
2025740,18,10,1995,12,male,388,52,41,3,0,3,0,0,0
2179777,20,4,1993,3,male,358,53,16,3,0,3,0,0,0
1384004,21,17,1992,3,male,1331,53,14,3,0,3,0,0,0
2172119,23,9,1990,1,male,276,53,39,3,0,3,0,0,0
1959922,25,5,1988,3,male,989,53,24,3,0,3,0,0,0
1813035,26,4,1987,4,female,652,53,36,3,0,3,0,0,0
1313335,33,6,1980,12,female,186,52,30,3,0,3,0,0,0
2006877,35,1,1978,12,female,1015,52,19,3,0,3,0,0,0
1214956,37,17,1976,4,male,143,53,33,3,0,3,0,0,0
1438010,39,27,1974,10,female,1112,53,44,3,1,3,1,0,0
1908503,40,20,1973,5,female,341,52,31,3,2,3,2,0,0
1531343,41,19,1972,3,male,51,53,22,3,2,3,2,0,0
1517464,47,7,1966,11,female,132,53,31,3,3,3,0,0,3
1147105,50,20,1963,11,female,1067,52,8,3,2,3,1,0,1
2039704,49,22,1964,5,female,250,53,41,3,3,3,1,0,2
2156755,60,21,1953,10,male,1106,53,41,3,3,3,3,0,0
1628029,65,26,1948,2,male,436,53,49,3,2,3,0,0,2
1630405,69,12,1944,2,female,233,53,40,3,3,3,1,0,2
1905762,70,7,1943,10,female,1030,53,27,3,2,3,1,0,1
1755951,70,1,1943,1,male,70,52,39,3,8,3,0,0,8
2044250,80,20,1933,11,male,96,52,33,3,7,3,3,0,4
2145138,16,24,1997,3,male,468,52,29,3,5,3,2,0,3
2081250,66,3,1947,8,male,51,52,41,3,10,3,0,0,10
1932901,74,5,1939,8,male,345,53,43,3,25,3,6,0,19
1854792,20,11,1993,3,male,9,53,45,3,11,3,6,0,5
1600753,51,29,1962,4,male,524,52,43,3,11,3,7,0,4
1457171,14,5,1999,7,female,99,53,22,3,7,3,7,0,0
1034329,15,11,1998,9,male,1743,53,28,3,15,3,4,0,11
2030523,68,1,1945,1,female,532,53,21,3,5,3,5,0,0
1966438,74,17,1939,4,female,811,53,30,3,15,3,7,0,8
2130334,86,15,1927,4,male,797,52,26,3,9,3,9,0,0
1863357,17,10,1996,7,male,147,52,31,4,0,0,0,4,0
1565852,21,4,1992,9,female,202,52,30,4,0,0,0,4,0
1809014,26,23,1987,5,male,422,53,29,4,0,0,0,4,0
1556274,26,16,1987,11,male,256,53,25,4,2,0,0,4,2
1722862,29,16,1984,4,male,172,52,31,4,5,0,3,4,2
1705832,31,11,1982,11,male,1483,53,19,4,3,0,0,4,3
1099077,34,14,1979,2,male,426,52,16,4,3,0,1,4,2
1146592,102,1,1911,11,female,429,52,17,4,7,0,3,4,4
1179570,16,26,1997,3,female,243,53,24,4,0,2,0,2,0
1539147,18,27,1995,3,female,196,52,48,4,2,2,0,2,2
1431773,23,10,1990,2,female,35,52,30,4,9,2,6,2,3
1849208,27,8,1986,2,male,356,52,15,4,8,3,4,1,4
1880156,27,20,1986,11,female,493,53,18,4,6,3,6,1,0
1847011,39,17,1974,2,female,1109,52,13,4,11,3,3,1,8
1577672,38,15,1975,9,male,104,52,47,4,0,4,0,0,0
1550300,108,15,1905,1,male,77,52,34,4,0,4,0,0,0
1915436,22,6,1991,9,male,650,52,39,4,0,4,0,0,0
2192615,23,1,1990,7,male,278,52,46,4,1,4,1,0,0
1388272,27,24,1986,8,male,628,52,45,4,1,4,0,0,1
1084993,32,3,1981,3,female,274,53,17,4,4,4,3,0,1
2103365,33,25,1980,1,male,98,52,45,4,5,4,4,0,1
2012855,37,3,1976,4,male,244,52,15,4,3,4,2,0,1
1922086,58,8,1955,9,male,119,52,23,4,13,4,7,0,6
1946931,72,6,1941,1,male,195,52,14,4,9,4,0,0,9
2100279,15,11,1998,3,male,719,52,28,4,6,4,4,0,2
1342908,16,24,1997,12,male,258,53,48,4,6,4,4,0,2
1854713,23,18,1990,12,female,498,52,10,4,10,4,8,0,2
1244421,25,5,1988,3,male,427,52,50,5,0,0,0,5,0
1135234,108,7,1905,1,male,290,53,17,5,0,0,0,5,0
1022411,17,1,1996,9,male,406,52,35,5,0,0,0,5,0
1815463,20,20,1993,7,female,526,52,38,5,2,0,0,5,2
1812106,23,5,1990,2,male,151,52,30,5,4,0,0,5,4
1076788,24,26,1989,9,male,45,53,44,5,7,0,2,5,5
1427073,25,1,1988,8,male,464,52,39,5,16,0,1,5,15
1294846,25,1,1988,4,female,313,53,46,5,2,2,2,3,0
1350692,28,14,1985,12,male,1685,53,25,5,2,2,1,3,1
1758525,27,10,1986,3,female,156,52,30,5,1,1,0,4,1
1850527,30,1,1983,1,male,116,52,36,5,4,3,3,2,1
2086049,31,1,1982,5,male,235,53,41,5,7,4,3,1,4
1333843,31,19,1982,3,male,296,53,33,5,0,5,0,0,0
1380583,32,28,1981,11,male,502,52,33,5,0,5,0,0,0
1716635,33,10,1980,10,male,21,52,38,5,2,5,2,0,0
1875358,35,30,1978,8,male,219,53,46,5,1,5,1,0,0
1452528,38,24,1975,12,male,903,52,17,5,3,5,2,0,1
2096790,37,13,1976,4,male,630,53,27,5,1,5,1,0,0
1275008,38,17,1975,8,male,425,53,17,5,6,5,3,0,3
1699062,39,31,1974,2,female,175,53,30,5,4,5,2,0,2
1734158,64,2,1949,8,male,212,53,41,5,13,5,13,0,0
1831122,108,9,1905,11,female,365,53,43,5,33,5,13,0,20
1624288,28,14,1985,9,male,549,52,20,5,15,5,12,0,3
1821650,43,25,1970,3,female,74,53,25,5,9,5,7,0,2
1321369,21,8,1992,10,female,188,52,34,5,53,5,34,0,19
1958489,22,15,1991,10,female,265,53,21,5,14,5,9,0,5
1408796,24,11,1989,2,male,609,53,38,5,181,5,59,0,122
1007224,30,11,1983,5,female,772,53,9,6,0,0,0,6,0
1079584,23,22,1990,3,NA,1997,52,24,6,0,0,0,6,0
1494517,15,15,1998,2,female,385,53,34,6,5,0,4,6,1
1200229,23,7,1990,2,male,174,53,36,6,7,0,5,6,2
1612204,32,9,1981,1,male,240,52,28,6,14,0,6,6,8
2095377,33,30,1980,3,male,65,53,43,6,2,2,0,4,2
1123016,36,19,1977,4,male,240,53,38,6,3,4,2,2,1
2118953,58,1,1955,1,male,1741,53,12,6,6,5,4,1,2
1325920,18,21,1995,5,female,294,53,35,6,22,5,11,1,11
1347293,18,10,1995,8,male,544,52,38,6,0,6,0,0,0
1356339,22,1,1991,1,male,155,52,27,6,0,6,0,0,0
2000301,21,11,1992,9,male,453,52,47,6,0,6,0,0,0
1215134,22,5,1991,7,male,416,52,28,6,1,6,0,0,1
2004183,29,29,1984,9,male,110,53,39,6,1,6,1,0,0
1650417,39,8,1974,6,male,220,52,39,6,3,6,3,0,0
1234021,39,14,1974,11,male,526,53,51,6,5,6,5,0,0
1388733,44,3,1969,5,male,1844,52,25,6,4,6,2,0,2
1354435,70,30,1943,9,male,10,53,48,6,20,6,9,0,11
2011066,103,7,1910,11,female,66,53,21,6,9,6,7,0,2
1799182,68,17,1945,5,female,111,53,32,6,9,6,4,0,5
1034012,16,12,1997,9,male,269,52,12,6,11,6,11,0,0
1722327,21,17,1992,7,male,11,53,51,6,9,6,9,0,0
2002720,23,23,1990,12,male,759,53,23,6,39,6,28,0,11
1293797,24,9,1989,6,male,329,52,39,6,16,6,15,0,1
1384314,26,3,1987,9,female,482,53,31,7,0,0,0,7,0
1606795,26,27,1987,9,male,1000,53,9,7,3,0,1,7,2
1553771,34,6,1979,2,male,165,53,33,7,5,0,1,7,4
1072502,35,24,1978,2,male,324,52,44,7,7,1,4,6,3
1050667,53,28,1960,11,female,126,52,12,7,2,2,0,5,2
1939739,18,6,1995,10,female,276,52,42,7,19,4,10,3,9
1046340,21,6,1992,5,male,306,53,22,7,1,7,1,0,0
2154826,25,1,1988,5,female,185,52,39,7,1,7,0,0,1
1894612,25,10,1988,12,male,268,52,32,7,1,7,1,0,0
1618981,26,10,1987,1,male,41,52,49,7,3,7,3,0,0
1828635,30,3,1983,4,male,745,53,38,7,4,7,3,0,1
1823544,41,24,1972,9,male,677,52,29,7,4,7,4,0,0
1040339,51,1,1962,12,male,401,53,33,7,7,7,6,0,1
1296072,51,19,1962,2,male,786,53,30,7,5,7,4,0,1
1301980,54,21,1959,5,male,245,53,41,7,10,7,10,0,0
1957427,56,19,1957,5,female,2209,53,20,7,8,7,5,0,3
1047189,58,18,1955,7,male,43,53,46,7,8,7,3,0,5
1276743,14,31,1999,3,female,109,53,17,7,14,7,11,0,3
1872570,14,19,1999,7,male,599,53,31,7,21,7,16,0,5
1393853,57,13,1956,7,male,308,53,44,7,20,7,19,0,1
1841745,52,25,1961,5,male,440,53,28,7,32,7,22,0,10
1807979,24,17,1989,12,female,255,53,24,7,31,7,29,0,2
2078009,59,26,1954,10,male,1377,53,19,7,23,7,14,0,9
2013358,59,16,1954,3,female,1508,52,20,7,17,7,11,0,6
1855942,18,21,1995,5,male,319,53,22,8,0,0,0,8,0
1757911,21,30,1992,4,male,415,53,42,8,2,0,0,8,2
1706290,49,18,1964,1,male,561,52,36,8,12,0,3,8,9
1280149,47,3,1966,10,male,474,53,19,8,20,0,5,8,15
1480389,19,3,1994,12,female,327,52,23,8,0,5,0,3,0
1455534,44,12,1969,6,female,2257,52,24,8,23,4,15,4,8
1805677,63,28,1950,3,male,436,53,21,8,18,7,14,1,4
2021043,18,25,1995,10,male,2390,52,12,8,23,6,17,2,6
1688966,27,1,1986,12,female,625,53,30,8,0,8,0,0,0
1225222,27,28,1986,2,male,265,53,44,8,0,8,0,0,0
1542750,32,1,1981,8,male,551,52,39,8,1,8,1,0,0
1886627,57,20,1956,9,male,554,52,37,8,3,8,2,0,1
1825481,18,15,1995,11,female,503,53,43,8,8,8,6,0,2
2049988,26,4,1987,9,female,71,52,25,8,32,8,25,0,7
1232578,44,24,1969,1,female,322,52,34,9,2,0,0,9,2
1527976,20,26,1993,1,female,404,52,34,9,3,0,2,9,1
1678179,24,4,1989,4,male,787,53,19,9,13,0,8,9,5
1473141,25,3,1988,7,male,583,53,34,9,19,0,1,9,18
1671630,58,30,1955,9,female,915,53,17,9,36,0,10,9,26
1990512,61,27,1952,8,female,372,53,30,9,18,7,11,2,7
1770793,21,23,1992,12,male,296,53,14,9,0,9,0,0,0
1137786,29,18,1984,8,male,406,53,45,9,1,9,1,0,0
1983034,46,6,1967,7,female,204,52,19,9,1,9,1,0,0
1339936,53,8,1960,6,male,261,53,39,9,0,9,0,0,0
1909946,19,15,1994,10,male,593,52,43,9,2,9,2,0,0
1486340,66,9,1947,1,male,116,53,41,9,6,9,6,0,0
1970588,17,28,1996,2,male,174,52,36,9,8,9,8,0,0
2031875,36,22,1977,1,male,279,52,36,9,40,9,35,0,5
1972138,55,8,1958,4,male,95,53,41,9,25,9,14,0,11
1869842,54,16,1959,11,male,37,52,45,9,20,9,16,0,4
1759920,13,1,2000,8,female,186,53,41,9,21,9,14,0,7
1549952,30,4,1983,1,male,1013,52,46,10,0,0,0,10,0
1962530,32,16,1981,5,female,488,52,22,10,1,0,0,10,1
1279386,40,19,1973,10,female,419,52,41,10,6,0,3,10,3
1022213,16,4,1997,8,female,400,53,37,10,29,0,3,10,26
1724108,21,11,1992,8,male,325,53,37,10,10,2,5,8,5
2102155,50,15,1963,5,male,618,52,32,10,10,7,8,3,2
1867702,62,24,1951,3,male,122,52,41,10,1,10,1,0,0
1246588,22,18,1991,7,male,93,52,16,10,0,10,0,0,0
1664742,108,1,1905,11,female,484,52,32,10,1,10,1,0,0
1983596,17,15,1996,11,male,348,53,33,10,0,10,0,0,0
1068583,20,28,1993,10,male,179,52,31,10,4,10,1,0,3
1500088,21,6,1992,2,male,208,53,22,10,47,10,20,0,27
2120904,24,20,1989,8,male,397,52,41,10,19,10,17,0,2
1193605,33,16,1980,1,female,1744,52,23,10,23,10,22,0,1
1577569,57,6,1956,2,female,1483,52,25,11,1,0,1,11,0
1382390,67,13,1946,12,male,1731,53,13,11,6,0,2,11,4
1669344,23,10,1990,4,female,216,53,19,11,107,0,39,11,68
1561446,87,14,1926,2,male,295,53,8,11,5,7,2,4,3
2137433,15,18,1998,7,male,233,53,43,11,5,11,4,0,1
1682397,42,13,1971,5,male,1271,53,35,11,5,11,4,0,1
1528237,21,27,1992,8,male,707,53,10,11,19,11,14,0,5
1172053,26,18,1987,6,male,791,52,31,11,24,11,24,0,0
1447523,49,15,1964,7,male,255,53,13,12,0,12,0,0,0
2106517,40,3,1973,8,male,416,53,36,12,1,12,1,0,0
1209952,43,21,1970,11,male,656,53,31,12,1,12,0,0,1
1770282,16,12,1997,1,male,391,53,37,12,3,12,2,0,1
1390251,25,1,1988,4,female,1460,53,36,12,14,12,9,0,5
2163859,26,27,1987,1,male,255,52,40,12,29,12,28,0,1
1535031,18,14,1995,3,female,1512,53,23,12,56,12,50,0,6
1780141,26,1,1987,5,male,371,53,39,13,2,0,0,13,2
1855756,27,26,1986,12,female,27,53,36,13,38,12,17,1,21
1605874,29,13,1984,3,female,382,52,49,13,4,13,4,0,0
1133404,62,31,1951,9,female,147,53,38,13,19,13,14,0,5
1503157,16,10,1997,1,female,1137,53,26,13,104,13,95,0,9
1292293,18,25,1995,2,male,272,53,28,14,2,0,0,14,2
1423396,22,5,1991,8,female,87,53,36,14,6,0,4,14,2
2154371,23,12,1990,2,male,311,53,39,14,4,0,1,14,3
1428091,28,19,1985,12,female,363,53,39,14,37,0,9,14,28
1976235,40,2,1973,10,female,433,53,13,14,56,9,52,5,4
1447363,40,6,1973,12,male,461,52,34,14,14,13,13,1,1
1589996,33,19,1980,7,male,51,52,40,14,2,14,2,0,0
1446641,64,15,1949,8,female,413,53,10,14,7,14,4,0,3
2090662,20,4,1993,10,male,248,52,29,14,3,14,3,0,0
1668763,23,28,1990,11,male,227,53,18,14,4,14,3,0,1
1186005,15,24,1998,12,female,73,53,49,14,19,14,18,0,1
1408807,19,18,1994,12,male,67,53,49,14,9,14,7,0,2
2180364,15,29,1998,2,female,318,52,21,14,54,14,53,0,1
2161334,28,4,1985,9,female,852,53,24,15,21,13,4,2,17
1620238,43,19,1970,5,male,734,53,33,15,10,13,7,2,3
2070707,26,1,1987,1,male,210,53,43,15,4,15,4,0,0
1204832,49,27,1964,8,male,97,53,51,15,4,15,1,0,3
1091719,58,16,1955,12,male,560,53,46,15,4,15,2,0,2
1797754,18,18,1995,5,male,171,52,39,15,17,15,10,0,7
1279295,24,8,1989,10,male,509,52,26,15,14,15,10,0,4
1841287,26,10,1987,2,female,1743,53,31,16,10,0,7,16,3
1337305,60,16,1953,7,female,111,53,34,16,62,6,45,10,17
1400204,108,30,1905,11,male,201,52,36,16,1,16,0,0,1
1851013,25,11,1988,12,male,670,53,32,16,7,16,3,0,4
1440247,33,6,1980,9,male,147,53,37,16,24,16,17,0,7
1373337,39,25,1974,10,female,1569,52,16,17,8,0,8,17,0
1580788,40,16,1973,1,female,902,52,23,17,5,0,3,17,2
1240450,47,31,1966,7,male,1399,52,38,17,38,0,11,17,27
1091921,62,10,1951,11,female,224,53,41,17,2,9,2,8,0
1492605,64,20,1949,3,male,302,52,36,17,0,14,0,3,0
1967337,27,14,1986,2,female,604,53,32,17,5,16,2,1,3
1093228,53,3,1960,8,male,50,52,44,17,0,17,0,0,0
2071305,18,28,1995,1,female,377,53,23,17,0,17,0,0,0
1118435,32,19,1981,8,male,75,53,46,17,18,17,18,0,0
1356141,32,31,1981,7,female,58,53,23,17,19,17,13,0,6
1348983,49,20,1964,11,female,1761,52,26,17,34,17,19,0,15
1662444,30,2,1983,2,male,907,52,34,17,42,17,30,0,12
1500216,34,12,1979,8,male,443,52,20,18,7,0,1,18,6
1982166,26,20,1987,1,female,233,52,35,18,14,1,2,17,12
1418449,30,22,1983,5,male,81,52,33,18,0,18,0,0,0
2113178,52,4,1961,5,male,83,53,39,18,9,18,6,0,3
2054440,17,1,1996,8,male,103,52,35,18,5,18,4,0,1
2087432,40,12,1973,5,male,1338,53,20,18,13,18,11,0,2
2181588,47,5,1966,7,male,901,53,9,18,56,18,46,0,10
1879447,18,2,1995,12,male,82,53,36,18,43,18,41,0,2
1812858,68,28,1945,12,female,1773,52,7,19,5,0,2,19,3
1713351,57,4,1956,2,female,1066,52,39,19,7,0,4,19,3
1307021,39,21,1974,7,male,1231,53,36,19,17,0,3,19,14
1506524,70,12,1943,10,male,168,52,26,19,0,19,0,0,0
1325592,31,12,1982,4,male,575,53,35,19,1,19,0,0,1
1792212,18,11,1995,4,female,555,52,30,19,9,19,1,0,8
2054649,22,18,1991,12,female,404,52,33,19,5,19,4,0,1
1824504,25,25,1988,8,male,1290,52,31,19,18,19,12,0,6
1586120,40,8,1973,12,male,1,53,50,20,4,0,3,20,1
1092646,26,15,1987,11,female,552,53,25,20,5,0,1,20,4
1262999,25,1,1988,2,male,1022,53,18,20,27,2,4,18,23
2015214,42,24,1971,6,female,303,53,23,20,11,10,11,10,0
2001980,23,17,1990,6,male,940,53,29,20,102,10,51,10,51
1480021,23,21,1990,10,male,464,52,39,20,0,19,0,1,0
1580342,33,15,1980,1,female,193,52,24,20,2,20,1,0,1
1715881,43,12,1970,12,male,232,52,43,20,7,20,1,0,6
1046112,22,29,1991,10,male,137,53,37,20,13,20,5,0,8
2001077,56,13,1957,4,female,384,52,29,20,26,20,26,0,0
1441291,60,18,1953,9,female,619,53,42,22,1,22,1,0,0
1250662,47,23,1966,2,female,708,53,30,22,9,22,6,0,3
1876936,31,15,1982,6,female,210,52,34,22,18,22,16,0,2
1697643,38,14,1975,7,male,1053,52,30,23,9,0,5,23,4
1072714,17,2,1996,4,male,515,53,28,23,54,0,10,23,44
1743744,17,4,1996,2,male,365,52,38,23,2,10,0,13,2
1066758,19,20,1994,2,male,15,53,17,23,10,23,7,0,3
2174833,29,25,1984,4,male,300,52,41,23,23,23,11,0,12
2134717,15,22,1998,5,male,24,53,48,23,16,23,15,0,1
1612322,25,27,1988,6,female,791,52,29,24,5,0,4,24,1
1210207,25,2,1988,10,female,360,52,40,24,52,0,21,24,31
1850781,51,1,1962,9,female,430,52,38,24,10,18,7,6,3
1632516,103,13,1910,11,male,631,53,13,24,59,24,14,0,45
1213690,108,26,1905,6,male,1031,52,28,24,40,24,6,0,34
1800909,55,23,1958,1,male,289,53,25,25,0,18,0,7,0
1332208,50,5,1963,9,female,469,53,39,25,50,25,40,0,10
1942753,26,10,1987,5,female,111,53,44,26,17,22,8,4,9
1066173,69,20,1944,10,male,1591,52,20,26,2,26,2,0,0
1042935,19,3,1994,1,male,543,53,21,27,32,20,19,7,13
1701050,21,30,1992,11,female,1499,52,19,27,0,27,0,0,0
2189808,27,14,1986,1,male,587,52,43,27,8,27,1,0,7
1556635,27,1,1986,7,male,145,53,45,27,6,27,6,0,0
1271235,45,8,1968,11,male,56,53,51,28,12,10,9,18,3
2154032,31,26,1982,12,female,1366,52,42,28,25,25,4,3,21
1019624,48,10,1965,5,female,544,53,39,28,40,28,37,0,3
2154600,34,24,1979,7,female,241,52,29,28,97,28,67,0,30
1028543,48,16,1965,5,female,626,52,17,29,29,7,24,22,5
1622111,23,19,1990,1,male,71,52,50,29,0,29,0,0,0
1479950,22,21,1991,4,female,511,52,13,29,0,29,0,0,0
1821338,52,8,1961,4,male,613,52,44,29,0,29,0,0,0
1147577,32,24,1981,9,male,792,53,17,29,5,29,3,0,2
1806226,45,12,1968,8,male,482,52,40,29,9,29,8,0,1
1326313,28,14,1985,12,male,315,53,44,29,9,29,8,0,1
2016552,63,25,1950,1,male,143,53,46,29,13,29,13,0,0
1640753,78,22,1935,3,female,154,53,51,29,9,29,5,0,4
1193657,65,3,1948,5,male,646,53,27,29,69,29,59,0,10
1157771,39,4,1974,5,male,323,53,52,31,1,6,1,25,0
1924732,33,17,1980,5,male,313,52,35,31,0,0,0,31,0
1898305,98,29,1915,11,female,318,52,25,31,49,21,20,10,29
1047735,20,24,1993,1,male,26,53,33,31,35,29,17,2,18
1161600,22,31,1991,3,male,27,53,46,30,105,28,81,2,24
1333308,34,27,1979,11,male,41,53,48,30,37,30,21,0,16
1101298,16,8,1997,9,male,22,52,45,30,49,30,39,0,10
1176171,22,14,1991,8,female,620,52,16,30,93,30,74,0,19
2031588,23,15,1990,9,male,223,53,27,33,2,2,2,31,0
1873018,61,16,1952,2,male,205,53,48,33,43,0,19,33,24
1401959,64,16,1949,9,male,103,53,26,33,43,0,18,33,25
1066197,16,9,1997,2,male,452,52,18,33,111,0,64,33,47
1810034,36,16,1977,6,male,199,53,30,33,7,23,3,10,4
1254572,43,12,1970,6,male,260,52,23,33,76,30,49,3,27
1192558,20,10,1993,4,male,1184,53,11,33,19,33,11,0,8
2031078,38,17,1975,4,female,715,52,30,33,14,33,3,0,11
2182821,68,12,1945,4,female,560,53,32,34,1,33,0,1,1
1398363,51,5,1962,7,male,70,53,47,34,1,34,1,0,0
1904136,28,19,1985,11,female,403,53,26,34,2,34,2,0,0
1017612,67,2,1946,7,female,200,53,34,34,39,34,25,0,14
1155331,27,7,1986,1,male,352,53,43,36,6,0,2,36,4
1572083,48,16,1965,1,female,1821,52,18,35,21,0,17,35,4
2157242,61,24,1952,4,male,15,52,43,36,231,0,16,36,215
1617908,76,19,1937,10,female,1192,52,32,35,7,34,2,1,5
2000766,21,12,1992,3,male,374,52,20,35,70,28,22,7,48
1244046,41,6,1972,9,female,33,53,51,35,113,35,35,0,78
1151797,66,25,1947,3,female,55,52,35,35,103,35,44,0,59
1896937,27,29,1986,1,female,290,53,34,37,55,6,16,31,39
1878953,28,30,1985,6,male,1184,53,22,37,78,22,23,15,55
1748010,18,8,1995,9,male,785,52,21,37,15,36,9,1,6
2017755,20,15,1993,10,male,295,53,39,37,8,37,5,0,3
1422996,70,20,1943,6,female,101,53,45,38,2,0,1,38,1
1615853,72,11,1941,7,female,258,52,40,39,26,10,20,29,6
2086649,47,7,1966,5,male,442,53,23,38,3,34,3,4,0
2185698,53,18,1960,10,female,33,52,18,39,28,31,14,8,14
1798648,32,11,1981,8,female,391,53,23,39,25,34,16,5,9
1236590,14,26,1999,12,male,429,53,32,38,0,38,0,0,0
1832937,18,23,1995,1,male,219,52,51,38,22,38,22,0,0
2050944,64,15,1949,2,female,172,52,13,39,26,39,17,0,9
1463918,33,9,1980,11,male,209,52,37,38,30,38,25,0,5
1018974,43,12,1970,8,male,336,52,23,39,86,39,82,0,4
1540132,66,23,1947,7,female,301,52,29,40,20,3,17,37,3
1399355,71,22,1942,2,male,91,53,51,40,19,36,18,4,1
1393658,103,3,1910,11,male,461,53,14,40,124,35,65,5,59
1569396,29,10,1984,7,male,320,53,35,40,2,40,2,0,0
1439471,51,3,1962,6,male,1193,53,17,40,5,40,4,0,1
1567754,25,20,1988,3,male,8,53,52,40,14,40,8,0,6
1474146,47,6,1966,12,female,945,52,45,40,26,40,23,0,3
1419664,63,30,1950,10,female,461,52,28,40,106,40,66,0,40
1487690,16,13,1997,11,female,428,53,19,41,6,10,2,31,4
1429769,22,4,1991,11,female,153,53,45,42,7,12,2,30,5
1223719,108,5,1905,4,male,166,53,37,42,19,39,11,3,8
1995184,26,28,1987,9,male,233,53,46,41,4,41,3,0,1
1311596,66,18,1947,5,male,412,53,28,42,6,42,5,0,1
1453080,23,1,1990,8,female,507,52,40,42,1,42,1,0,0
1328228,31,1,1982,1,male,621,52,41,41,27,41,19,0,8
1015469,36,31,1977,6,female,282,53,41,42,72,42,72,0,0
2186687,22,22,1991,9,female,413,52,34,44,43,44,43,0,0
1902471,35,25,1978,12,female,69,52,41,44,42,44,27,0,15
1897174,50,21,1963,12,male,1376,52,31,44,93,44,78,0,15
1513553,55,14,1958,12,male,532,53,36,45,17,41,10,4,7
1056744,31,15,1982,12,male,334,52,37,45,8,45,7,0,1
1928247,65,28,1948,9,female,1379,52,28,45,15,45,14,0,1
1598339,63,10,1950,10,female,469,52,30,45,40,45,38,0,2
1594750,18,27,1995,6,female,168,53,27,45,110,45,82,0,28
1985093,18,9,1995,5,male,432,52,32,47,6,47,3,0,3
1702188,19,5,1994,6,male,645,52,34,46,1,46,1,0,0
2131927,24,31,1989,7,male,692,53,17,47,0,47,0,0,0
1876579,54,19,1959,6,male,205,52,40,46,9,46,7,0,2
1101649,62,9,1951,10,male,141,53,31,47,84,47,60,0,24
1876200,46,4,1967,4,female,673,53,32,47,219,47,175,0,44
1874961,30,30,1983,3,male,902,53,43,49,11,7,10,42,1
1997534,49,5,1964,3,male,417,53,11,48,1,45,1,3,0
1406933,18,8,1995,2,female,480,52,51,49,13,39,13,10,0
1334622,50,15,1963,7,male,173,53,48,49,8,49,5,0,3
1802049,38,1,1975,9,male,339,52,28,49,26,49,24,0,2
1180209,66,1,1947,10,male,362,53,34,48,60,48,47,0,13
1468072,94,1,1919,6,female,2080,53,26,48,70,48,42,0,28
1333176,94,9,1919,11,female,195,53,33,51,41,35,34,16,7
1135159,19,1,1994,8,female,457,53,11,51,10,39,8,12,2
1852595,43,26,1970,5,female,1516,52,38,50,1,50,1,0,0
1858333,24,29,1989,1,male,24,53,43,50,30,50,21,0,9
2077161,52,18,1961,1,male,74,53,38,50,15,50,15,0,0
1127004,41,1,1972,2,female,509,53,24,50,74,50,67,0,7
1200562,44,11,1969,5,male,112,52,38,52,29,0,12,52,17
1687636,64,27,1949,7,female,1220,53,35,52,23,10,15,42,8
1335272,24,1,1989,4,female,321,52,33,52,39,0,14,52,25
1589626,27,11,1986,2,female,321,53,41,53,0,53,0,0,0
2127392,52,18,1961,4,female,75,52,43,52,4,52,2,0,2
1951581,16,17,1997,10,male,170,52,27,52,19,52,17,0,2
1603170,19,21,1994,5,male,341,53,45,55,0,16,0,39,0
1164155,41,31,1972,9,male,269,53,34,54,12,51,11,3,1
1598900,47,3,1966,4,female,94,53,38,55,39,54,35,1,4
1402373,57,5,1956,3,male,70,52,21,55,18,55,16,0,2
1229057,34,13,1979,12,female,986,52,26,55,45,55,39,0,6
1396408,26,8,1987,3,male,136,52,30,58,31,0,2,58,29
1167816,31,11,1982,9,female,615,52,27,56,42,50,29,6,13
1388806,29,30,1984,5,female,125,53,43,56,8,56,5,0,3
1310196,25,1,1988,10,female,585,52,29,58,70,58,62,0,8
1086758,56,14,1957,6,male,186,53,39,59,0,59,0,0,0
1686098,43,27,1970,9,female,2046,53,20,59,87,59,70,0,17
1333965,25,10,1988,7,female,1420,53,46,62,114,0,40,62,74
1164070,55,14,1958,12,male,937,52,47,63,65,49,28,14,37
2158464,20,2,1993,7,female,33,53,51,61,0,61,0,0,0
1101365,19,11,1994,10,male,593,52,9,63,131,63,109,0,22
1828296,64,13,1949,6,female,684,52,48,65,0,8,0,57,0
1450774,57,17,1956,11,female,174,52,37,65,52,44,39,21,13
1324169,19,24,1994,2,female,1280,53,31,65,134,64,60,1,74
1409806,30,25,1983,9,female,1074,53,15,65,0,65,0,0,0
2057121,41,4,1972,11,female,212,52,25,68,36,28,21,40,15
1183338,73,27,1940,10,male,605,52,36,67,31,67,26,0,5
1007600,82,17,1931,11,female,422,53,34,67,40,67,29,0,11
1712258,25,13,1988,4,female,109,52,30,68,36,68,26,0,10
1281412,29,8,1984,2,female,352,53,20,67,109,67,64,0,45
1003481,26,19,1987,3,male,255,53,26,66,139,66,35,0,104
1067533,34,1,1979,10,female,184,53,47,70,25,55,2,15,23
1519673,53,14,1960,2,female,353,53,27,69,20,69,8,0,12
1805425,58,21,1955,5,male,953,53,35,72,5,2,1,70,4
1070142,70,7,1943,1,female,77,53,38,73,178,2,110,71,68
1261113,26,29,1987,2,male,59,52,39,74,9,74,8,0,1
2100184,51,30,1962,10,male,556,52,50,73,8,73,6,0,2
1594903,56,6,1957,11,male,89,53,34,77,44,75,39,2,5
1707481,37,1,1976,3,female,771,53,14,78,13,0,9,78,4
1460985,54,4,1959,1,male,62,53,38,78,77,0,34,78,43
1712478,15,20,1998,11,female,1824,53,36,80,74,26,38,54,36
1059643,31,10,1982,2,female,497,52,28,79,10,63,4,16,6
1255477,59,15,1954,1,male,306,53,38,78,26,78,24,0,2
1328592,35,26,1978,12,female,422,53,37,80,70,80,20,0,50
1520922,44,14,1969,1,male,1431,52,45,82,29,47,14,35,15
1911312,17,30,1996,12,female,645,53,38,82,113,22,74,60,39
1492962,32,28,1981,7,female,310,52,43,82,34,81,9,1,25
1735708,23,28,1990,9,female,618,53,24,84,98,82,91,2,7
1917744,25,10,1988,11,male,288,53,39,81,60,81,37,0,23
1334848,16,1,1997,7,female,35,52,31,84,73,84,24,0,49
1543650,61,12,1952,7,male,155,53,42,86,132,6,61,80,71
1052493,17,4,1996,3,female,159,53,25,86,61,86,47,0,14
1801728,18,21,1995,8,male,759,52,17,91,45,56,25,35,20
1740819,108,2,1905,8,male,1575,52,17,88,108,45,76,43,32
1196031,57,17,1956,8,female,195,53,39,91,13,91,8,0,5
1018107,27,26,1986,6,female,725,53,37,91,1,91,0,0,1
1781821,37,29,1976,7,female,1717,53,21,90,12,90,10,0,2
1066497,21,7,1992,11,male,256,53,18,90,51,90,35,0,16
1218494,66,15,1947,4,female,160,52,11,89,79,89,57,0,22
1734431,50,11,1963,9,female,183,52,30,91,140,91,112,0,28
1694725,38,28,1975,7,female,286,53,36,91,160,91,112,0,48
2125640,27,21,1986,1,male,555,52,36,92,49,88,40,4,9
1053013,22,7,1991,1,female,225,53,38,92,35,89,24,3,11
1282389,24,6,1989,9,female,430,53,49,96,93,24,27,72,66
1353271,37,22,1976,1,female,353,52,36,98,21,98,21,0,0
1240932,61,29,1952,6,female,260,52,32,98,195,98,182,0,13
1170939,14,1,1999,5,male,1039,53,32,101,54,0,14,101,40
1763681,27,3,1986,4,male,114,53,33,102,39,2,12,100,27
1137097,33,10,1980,2,female,592,52,15,100,151,0,65,100,86
1900494,58,22,1955,7,male,60,53,41,102,238,23,56,79,182
1220451,100,18,1913,1,female,502,53,23,104,38,85,16,19,22
1110424,33,27,1980,4,male,495,52,13,100,20,93,8,7,12
1689033,37,31,1976,12,female,980,52,25,103,43,92,23,11,20
1334700,68,25,1945,6,female,99,52,49,100,144,80,122,20,22
1339398,21,15,1992,12,female,22,53,27,103,96,95,44,8,52
1847018,54,23,1959,7,male,579,52,22,102,124,102,69,0,55
1995361,43,8,1970,4,female,984,52,31,109,61,0,31,109,30
1944335,44,4,1969,5,NA,2290,53,29,106,71,104,44,2,27
1519242,48,17,1965,9,female,1043,53,26,113,89,112,86,1,3
1894495,43,14,1970,6,male,251,52,37,112,16,112,13,0,3
1288580,36,21,1977,11,male,647,52,36,111,20,111,17,0,3
1023761,56,20,1957,9,male,440,52,40,112,136,112,113,0,23
1326217,45,29,1968,4,male,1823,53,16,115,16,10,9,105,7
1904603,59,19,1954,8,female,761,52,33,114,52,0,11,114,41
2143641,23,27,1990,2,female,382,53,33,119,19,109,13,10,6
1968416,54,11,1959,12,male,224,53,34,117,0,117,0,0,0
1103482,35,7,1978,4,male,250,52,50,118,19,118,17,0,2
1432711,34,28,1979,5,female,358,52,29,115,52,115,36,0,16
1816242,63,11,1950,1,male,242,53,26,115,67,115,60,0,7
1962337,43,1,1970,12,male,150,52,42,114,142,114,122,0,20
1828756,31,1,1982,9,male,269,52,21,117,77,117,46,0,31
1699976,72,31,1941,10,female,152,53,41,120,207,0,98,120,109
1881035,14,1,1999,10,female,170,53,41,121,226,56,139,65,87
1763671,18,1,1995,8,female,195,52,22,121,136,118,76,3,60
1625262,30,13,1983,8,female,231,53,36,130,1,0,1,130,0
1086571,25,24,1988,7,female,1520,53,19,125,6,4,1,121,5
1939089,95,29,1918,7,male,155,53,38,127,47,0,13,127,34
1634672,54,24,1959,6,male,510,53,23,128,3,95,1,33,2
1082056,20,11,1993,11,male,522,52,44,131,47,0,4,131,43
1781471,58,25,1955,12,male,448,52,41,131,63,24,11,107,52
1219212,25,24,1988,3,female,442,53,41,134,1,80,0,54,1
1915340,19,20,1994,11,female,407,52,18,136,480,135,450,1,30
1108553,24,23,1989,10,male,549,52,38,131,32,131,25,0,7
1850620,52,2,1961,5,female,1126,53,22,139,9,0,2,139,7
1471939,22,28,1991,1,female,614,53,32,140,16,0,7,140,9
1453896,67,24,1946,7,female,395,53,9,140,34,0,9,140,25
1269341,36,21,1977,10,female,191,52,20,139,13,33,4,106,9
2097158,55,16,1958,3,female,101,53,45,143,5,120,1,23,4
2006070,47,12,1966,7,female,47,53,33,141,69,141,60,0,9
1561558,37,2,1976,10,male,421,53,38,149,22,0,10,149,12
1752048,29,1,1984,9,female,132,53,43,144,45,28,23,116,22
1408168,50,20,1963,10,female,62,53,13,148,81,79,63,69,18
1141366,68,2,1945,10,female,278,53,25,145,181,110,31,35,150
1255930,50,8,1963,12,male,253,53,45,147,146,147,93,0,53
1924741,20,2,1993,11,male,320,52,42,157,26,13,9,144,17
1318971,43,21,1970,7,female,615,53,40,153,135,43,122,110,13
1451257,64,4,1949,6,female,216,53,53,154,15,154,14,0,1
1306011,22,12,1991,11,female,563,52,25,152,66,152,50,0,16
2086815,47,15,1966,8,male,93,52,26,155,36,155,31,0,5
1460213,61,20,1952,3,female,373,53,19,156,66,156,65,0,1
1974632,57,6,1956,11,female,1065,53,16,160,10,0,0,160,10
1265828,21,10,1992,7,female,671,53,32,159,224,0,65,159,159
1446288,35,13,1978,4,male,121,53,46,160,94,119,35,41,59
1812235,40,30,1973,2,female,786,53,33,158,58,158,15,0,43
2138764,33,12,1980,3,female,1128,52,37,166,54,115,18,51,36
1363764,34,1,1979,9,female,742,52,22,168,49,168,46,0,3
1726592,41,26,1972,8,female,47,53,28,171,109,171,63,0,46
1668905,82,20,1931,8,female,667,53,2,181,64,0,21,181,43
1203040,86,4,1927,6,male,76,53,40,175,43,175,23,0,20
2063876,60,31,1953,1,female,580,52,33,183,39,0,19,183,20
1436004,21,10,1992,2,female,220,52,30,186,129,180,26,6,103
1058034,31,6,1982,10,female,615,53,29,186,124,184,82,2,42
1439280,31,12,1982,3,female,431,52,24,187,0,187,0,0,0
1116762,75,5,1938,8,male,106,53,43,186,60,186,8,0,52
1496407,66,7,1947,8,male,391,53,45,194,20,194,18,0,2
1494937,60,13,1953,12,male,549,53,32,210,25,0,12,210,13
1897194,28,26,1985,1,female,672,53,35,205,34,0,15,205,19
1216012,23,7,1990,7,female,212,53,44,203,391,42,148,161,243
1890609,43,1,1970,2,female,338,52,37,206,29,206,28,0,1
1362652,24,11,1989,1,male,164,52,16,204,64,204,44,0,20
1731818,21,23,1992,9,female,571,52,27,201,60,201,37,0,23
1286157,23,8,1990,5,female,368,52,39,214,57,0,28,214,29
1441660,39,7,1974,10,female,272,52,33,215,72,5,50,210,22
1104332,22,23,1991,9,female,567,53,28,219,64,56,40,163,24
1683481,22,20,1991,7,female,672,52,26,212,37,212,12,0,25
1512934,36,20,1977,5,female,48,53,46,223,1,223,1,0,0
1410835,23,3,1990,12,female,164,53,8,233,128,233,65,0,63
1497801,57,18,1956,3,female,220,53,30,234,155,8,23,226,132
1636134,54,29,1959,4,female,615,52,27,241,109,203,89,38,20
1611701,44,22,1969,7,female,796,53,29,244,103,238,64,6,39
1583968,57,5,1956,12,female,414,53,37,246,118,246,45,0,73
1523906,70,22,1943,9,male,643,53,28,249,82,0,38,249,44
1965956,21,20,1992,2,female,812,52,37,249,86,0,6,249,80
1359457,44,19,1969,11,female,250,53,41,249,43,131,6,118,37
1536253,47,25,1966,6,female,891,53,37,247,72,87,30,160,42
1029808,50,6,1963,11,female,99,53,40,248,41,228,20,20,21
1271656,47,7,1966,11,female,962,52,22,271,131,229,97,42,34
1165036,108,1,1905,7,female,151,53,34,265,234,259,109,6,125
1052700,28,18,1985,9,female,142,52,35,264,110,264,110,0,0
2056770,29,10,1984,7,female,1590,53,24,288,44,1,35,287,9
1453882,40,8,1973,4,female,217,53,45,291,167,5,73,286,94
1494413,59,27,1954,7,female,131,52,42,278,414,5,212,273,202
1201656,65,17,1948,7,female,863,52,29,283,133,218,78,65,55
1378087,55,26,1958,11,female,862,53,24,279,91,278,57,1,34
1968865,17,27,1996,2,male,342,52,40,279,34,279,28,0,6
1948335,27,22,1986,8,female,318,52,29,297,149,4,49,293,100
1094609,54,13,1959,1,male,1090,52,37,296,99,3,4,293,95
1439463,68,27,1945,8,male,421,53,42,303,93,292,59,11,34
1746440,23,30,1990,10,female,1873,52,16,303,88,273,21,30,67
1417354,41,4,1972,10,female,922,52,22,302,80,302,56,0,24
1094514,51,4,1962,5,female,421,53,42,320,52,0,27,320,25
1161898,66,11,1947,4,male,1383,53,25,327,114,0,16,327,98
1297246,52,2,1961,11,female,1692,52,28,325,320,274,210,51,110
1661478,61,28,1952,12,female,159,52,28,323,23,323,22,0,1
1119801,40,23,1973,10,female,207,53,27,309,145,309,116,0,29
1338348,22,17,1991,2,male,157,52,26,328,162,200,86,128,76
2090055,45,7,1968,4,male,151,53,26,331,33,330,23,1,10
2060495,71,22,1942,3,female,220,52,33,332,1105,332,784,0,321
1484170,63,17,1950,3,female,53,53,35,366,161,0,64,366,97
1727267,19,10,1994,9,female,20,52,36,361,95,361,45,0,50
1572024,18,14,1995,9,male,232,52,30,362,205,362,135,0,70
2110392,42,16,1971,4,male,76,53,45,403,344,403,344,0,0
1724395,24,12,1989,8,male,332,52,35,431,74,431,73,0,1
1721912,25,1,1988,11,female,1687,52,40,467,5,462,3,5,2
1071856,25,31,1988,4,male,155,52,31,467,38,467,18,0,20
1018553,56,12,1957,9,female,393,52,41,477,322,477,264,0,58
1540438,52,28,1961,7,female,165,53,3,476,1392,476,844,0,548
1970647,36,16,1977,6,female,222,52,44,490,101,308,60,182,41
1960001,25,2,1988,11,female,289,53,36,485,321,480,119,5,202
1168359,14,12,1999,10,male,111,53,52,493,13,493,9,0,4
1736953,82,11,1931,2,male,62,53,41,498,99,498,90,0,9
1418242,75,4,1938,3,female,1355,52,20,598,292,270,164,328,128
1667850,49,28,1964,1,female,234,52,22,566,516,150,205,416,311
1161190,49,14,1964,12,female,796,53,35,573,1328,144,844,429,484
1352005,63,21,1950,6,female,1309,53,17,568,53,412,39,156,14
1683978,70,7,1943,9,female,600,53,25,649,97,0,27,649,70
1096642,36,7,1977,1,female,1080,53,48,628,690,0,30,628,660
1848151,51,16,1962,5,female,1551,53,27,657,150,590,84,67,66
1717717,71,7,1942,9,female,1718,52,18,610,789,535,63,75,726
2143342,98,1,1915,10,female,703,52,47,614,94,614,91,0,3
2096176,46,10,1967,5,female,414,52,32,710,58,710,39,0,19
1509089,25,4,1988,9,male,7,52,32,730,491,730,366,0,125
1875079,16,30,1997,2,female,77,53,46,798,82,798,30,0,52
1500733,18,18,1995,9,female,251,52,40,886,332,886,270,0,62
1141025,56,10,1957,5,male,302,53,29,952,828,952,632,0,196
1045695,58,16,1955,1,female,147,52,39,1132,144,7,7,1125,137
1852716,47,9,1966,1,female,95,53,50,1161,191,1128,86,33,105
1815278,39,29,1974,12,female,1766,53,28,1205,77,1205,71,0,6
1826574,34,24,1979,5,female,1599,52,28,1477,858,28,234,1449,624
1802616,37,9,1976,11,female,281,52,36,1816,77,1816,50,0,27
2101407,28,19,1985,10,female,409,53,24,1546,220,1546,151,0,69
1231641,31,29,1982,6,female,306,52,46,3245,295,0,145,3245,150
1813254,28,13,1985,11,female,1254,53,26,9884,6793,2892,3329,6992,3464
1282176,28,8,1985,4,female,107,52,39,4910,390,4910,93,0,297
1204638,50,6,1963,12,female,199,55,40,0,0,0,0,0,0
1590412,37,8,1976,10,male,14,54,54,0,0,0,0,0,0
1336474,65,7,1948,12,female,252,55,22,0,0,0,0,0,0
1241924,38,8,1975,5,male,173,54,43,0,0,0,0,0,0
1700955,59,16,1954,7,male,95,54,48,0,0,0,0,0,0
2031307,56,11,1957,8,male,41,54,33,0,0,0,0,0,0
1799818,50,16,1963,9,male,61,54,49,0,0,0,0,0,0
1494622,18,18,1995,1,male,582,55,34,0,0,0,0,0,0
1629284,69,5,1944,1,male,133,55,18,0,0,0,0,0,0
1670239,30,25,1983,6,male,408,54,26,0,0,0,0,0,0
1607222,71,1,1942,8,male,84,54,47,0,0,0,0,0,0
1144112,31,19,1982,9,male,708,54,37,0,6,0,0,0,6
2152880,101,13,1912,9,male,565,54,32,0,0,0,0,0,0
1089359,30,23,1983,9,male,96,55,37,0,2,0,2,0,0
1660856,29,24,1984,11,female,191,54,28,0,2,0,0,0,2
1587946,48,13,1965,11,male,74,55,45,0,0,0,0,0,0
1272774,58,4,1955,12,male,502,54,52,0,0,0,0,0,0
1863319,79,26,1934,12,male,144,55,18,0,23,0,12,0,11
1595240,33,31,1980,1,male,450,54,12,0,53,0,27,0,26
1932553,59,19,1954,4,male,362,54,24,0,0,0,0,0,0
1252295,35,4,1978,6,male,339,55,38,0,0,0,0,0,0
1071698,56,16,1957,6,male,248,54,33,0,0,0,0,0,0
1893740,55,2,1958,7,female,25,54,14,0,2,0,2,0,0
1275778,75,19,1938,8,male,37,55,19,0,0,0,0,0,0
2005434,58,16,1955,9,male,402,54,31,0,2,0,0,0,2
1255482,74,31,1939,4,male,185,54,35,0,1,0,1,0,0
1606883,17,1,1996,5,male,987,54,25,0,0,0,0,0,0
2143579,19,4,1994,7,male,261,55,36,0,0,0,0,0,0
2081361,23,19,1990,8,male,650,55,35,0,0,0,0,0,0
1748353,53,15,1960,10,male,384,55,10,0,6,0,5,0,1
1365577,58,26,1955,11,male,404,55,33,0,0,0,0,0,0
1431788,31,5,1982,12,female,231,55,15,0,0,0,0,0,0
1885076,19,8,1994,2,male,488,55,47,0,0,0,0,0,0
1760173,66,11,1947,2,male,142,55,50,0,13,0,2,0,11
1174483,57,16,1956,3,male,275,54,32,0,0,0,0,0,0
1602784,64,27,1949,4,male,571,55,31,0,0,0,0,0,0
1744795,63,16,1950,5,female,339,54,39,0,0,0,0,0,0
1794742,33,15,1980,5,male,107,55,53,0,1,0,1,0,0
1628730,37,19,1976,7,female,176,54,22,0,0,0,0,0,0
1689439,34,12,1979,3,female,247,54,42,0,2,0,2,0,0
1687915,78,25,1935,4,male,50,55,5,0,3,0,0,0,3
1880551,46,24,1967,4,female,560,55,38,0,0,0,0,0,0
1971962,20,24,1993,5,male,950,55,30,0,0,0,0,0,0
1483655,63,6,1950,5,male,519,54,22,0,0,0,0,0,0
1883937,65,23,1948,6,female,820,54,12,0,0,0,0,0,0
1507310,26,1,1987,6,male,241,54,32,0,2,0,0,0,2
1901489,19,24,1994,8,female,544,54,37,0,0,0,0,0,0
1013012,54,2,1959,9,female,438,54,14,0,0,0,0,0,0
1993844,34,3,1979,12,male,817,55,28,0,0,0,0,0,0
1429308,66,23,1947,1,male,519,55,41,0,2,0,2,0,0
1504492,57,24,1956,1,male,231,54,32,0,18,0,16,0,2
1438781,60,17,1953,2,female,288,54,33,0,0,0,0,0,0
2178270,81,26,1932,3,female,300,54,24,0,24,0,12,0,12
1606896,54,28,1959,4,female,714,54,41,0,5,0,2,0,3
1506529,59,3,1954,6,female,460,54,8,0,1,0,1,0,0
2048193,58,18,1955,11,male,333,54,34,0,15,0,8,0,7
2142000,21,22,1992,2,male,628,55,43,0,0,0,0,0,0
1433799,46,21,1967,4,male,401,55,43,0,0,0,0,0,0
1687580,23,5,1990,7,male,205,54,44,0,0,0,0,0,0
2041941,57,20,1956,11,male,342,55,35,0,2,0,0,0,2
1283359,39,26,1974,12,female,357,54,43,0,0,0,0,0,0
1709714,53,4,1960,1,male,616,55,28,0,0,0,0,0,0
1126053,30,6,1983,3,male,325,54,22,0,1,0,1,0,0
1670970,36,11,1977,3,male,238,55,37,0,8,0,1,0,7
1702459,71,20,1942,5,male,510,55,35,0,0,0,0,0,0
1231558,25,1,1988,6,male,895,54,2,0,7,0,7,0,0
2066377,21,22,1992,6,female,397,54,23,0,8,0,4,0,4
1376546,26,22,1987,8,male,7,54,42,0,0,0,0,0,0
1220972,24,22,1989,9,male,52,54,40,0,1,0,0,0,1
1611799,36,25,1977,11,male,536,54,15,0,21,0,7,0,14
1342384,48,20,1965,1,male,276,54,31,0,6,0,6,0,0
1523098,23,2,1990,4,female,341,54,32,0,0,0,0,0,0
1975231,65,4,1948,6,female,373,54,36,0,43,0,27,0,16
1176425,14,15,1999,8,male,245,55,27,0,1,0,1,0,0
1937645,47,15,1966,8,male,174,54,34,0,0,0,0,0,0
2175108,54,4,1959,8,male,151,55,47,0,8,0,5,0,3
1433089,43,11,1970,11,male,1942,55,25,0,3,0,0,0,3
1897436,59,30,1954,11,male,370,55,43,0,0,0,0,0,0
1592162,48,14,1965,7,male,242,54,34,0,0,0,0,0,0
1717397,68,21,1945,8,male,319,54,38,0,0,0,0,0,0
1445171,18,28,1995,12,female,267,54,49,0,0,0,0,0,0
1653338,49,3,1964,1,male,97,54,51,0,1,0,0,0,1
1650010,24,10,1989,1,male,59,55,48,0,0,0,0,0,0
2004608,44,27,1969,5,male,267,55,42,0,0,0,0,0,0
1724137,100,13,1913,10,male,444,54,38,0,1,0,1,0,0
1038621,44,30,1969,10,female,420,55,36,0,4,0,4,0,0
1116419,53,27,1960,10,male,297,54,43,0,0,0,0,0,0
1538989,36,29,1977,11,male,150,54,24,0,0,0,0,0,0
1852752,63,4,1950,1,male,474,54,26,0,0,0,0,0,0
1678786,54,5,1959,5,male,235,55,39,0,1,0,0,0,1
1304341,25,2,1988,6,male,710,54,22,0,0,0,0,0,0
2109921,55,9,1958,6,male,823,54,13,0,0,0,0,0,0
1576511,59,25,1954,12,male,343,54,41,0,0,0,0,0,0
2041440,33,6,1980,8,male,1090,55,42,0,0,0,0,0,0
1289932,57,27,1956,12,male,215,55,30,0,0,0,0,0,0
1039337,14,9,1999,1,male,452,55,42,0,0,0,0,0,0
1349997,13,18,2000,1,male,391,54,50,0,3,0,1,0,2
1805595,15,4,1998,7,male,500,55,40,0,0,0,0,0,0
2091950,14,31,1999,8,male,145,54,40,0,8,0,0,0,8
1458921,14,21,1999,11,male,260,55,26,0,6,0,6,0,0
1354777,14,15,1999,1,male,597,54,31,0,0,0,0,0,0
1182510,14,9,1999,1,male,579,54,25,0,1,0,1,0,0
1994738,15,16,1998,2,male,172,54,48,0,0,0,0,0,0
1350189,15,31,1998,7,male,256,54,31,0,0,0,0,0,0
1783809,15,23,1998,2,male,555,55,51,0,0,0,0,0,0
1673261,15,23,1998,11,male,509,54,32,0,0,0,0,0,0
1022066,15,18,1998,12,male,393,55,44,0,0,0,0,0,0
1435160,15,11,1998,1,male,495,54,35,0,0,0,0,0,0
1610466,15,1,1998,4,male,864,54,37,0,1,0,1,0,0
1641341,17,21,1996,3,female,607,54,42,0,8,0,2,0,6
1549974,17,19,1996,3,male,210,54,44,0,3,0,0,0,3
1329302,17,12,1996,6,male,544,54,46,0,0,0,0,0,0
1046547,17,18,1996,6,male,323,54,41,0,2,0,0,0,2
1664957,16,16,1997,7,male,615,54,40,0,0,0,0,0,0
1757540,16,12,1997,9,male,329,54,23,0,0,0,0,0,0
1969511,16,22,1997,11,male,285,54,15,0,2,0,2,0,0
1676754,16,12,1997,5,female,429,55,23,0,1,0,1,0,0
1156968,16,7,1997,10,male,1451,54,45,0,1,0,0,0,1
1657832,16,5,1997,12,male,210,54,42,0,0,0,0,0,0
1734926,16,21,1997,1,male,298,55,38,0,0,0,0,0,0
1819056,17,12,1996,7,male,326,54,42,0,9,0,0,0,9
2035692,17,1,1996,11,female,233,55,47,0,2,0,0,0,2
2084292,17,7,1996,4,male,742,55,17,0,0,0,0,0,0
1588653,17,10,1996,4,male,434,55,22,0,2,0,2,0,0
1243672,17,3,1996,1,male,164,54,42,0,2,0,1,0,1
1646886,19,24,1994,6,male,472,54,25,0,2,0,1,0,1
1545791,19,4,1994,7,male,734,54,37,0,2,0,1,0,1
1525793,18,9,1995,8,male,310,55,49,0,0,0,0,0,0
1962480,18,23,1995,11,male,87,54,18,0,2,0,0,0,2
1437879,18,14,1995,5,male,990,54,45,0,3,0,2,0,1
1622345,18,12,1995,6,male,980,54,39,0,0,0,0,0,0
1538429,18,12,1995,9,male,1073,55,30,0,3,0,2,0,1
1755340,18,25,1995,11,female,136,54,37,0,0,0,0,0,0
1004497,18,7,1995,1,male,1262,54,26,0,0,0,0,0,0
1413205,19,15,1994,5,female,478,55,46,0,0,0,0,0,0
1908355,19,19,1994,1,male,149,54,41,0,3,0,0,0,3
1636176,19,1,1994,12,male,422,55,49,0,11,0,8,0,3
1312656,19,15,1994,12,female,427,54,23,0,0,0,0,0,0
1780506,19,6,1994,8,male,306,54,50,0,0,0,0,0,0
1813673,19,19,1994,10,male,1093,55,24,0,2,0,2,0,0
2085355,19,1,1994,4,female,797,54,14,0,0,0,0,0,0
1821811,19,31,1994,7,male,639,55,12,0,0,0,0,0,0
1156711,19,2,1994,10,male,233,54,34,0,1,0,1,0,0
1213515,21,11,1992,2,male,179,54,49,0,0,0,0,0,0
1736259,20,19,1993,6,female,463,54,36,0,0,0,0,0,0
1410457,20,1,1993,9,male,288,54,28,0,8,0,7,0,1
1701822,20,9,1993,1,male,1417,55,28,0,2,0,1,0,1
1396610,20,25,1993,7,male,457,54,30,0,5,0,0,0,5
1096489,20,11,1993,2,male,760,55,51,0,0,0,0,0,0
1744395,20,30,1993,7,male,272,55,4,0,10,0,2,0,8
1983449,22,11,1991,9,NA,813,54,38,0,0,0,0,0,0
1121006,21,29,1992,11,male,742,55,44,0,0,0,0,0,0
1004972,21,22,1992,7,male,1204,55,11,0,0,0,0,0,0
1406021,21,7,1992,5,female,506,55,14,0,0,0,0,0,0
1729882,23,8,1990,9,female,1476,55,21,0,7,0,3,0,4
2167564,23,10,1990,10,female,370,55,49,0,0,0,0,0,0
1746155,22,25,1991,11,male,1370,54,41,0,0,0,0,0,0
1651564,22,16,1991,2,male,270,54,43,0,4,0,2,0,2
1868583,22,3,1991,10,male,712,55,26,0,0,0,0,0,0
1856204,22,21,1991,9,female,1606,55,21,0,0,0,0,0,0
1245215,22,16,1991,3,male,723,54,47,0,10,0,4,0,6
1085664,22,2,1991,4,male,851,54,38,0,0,0,0,0,0
1412430,22,12,1991,9,male,1636,54,25,0,0,0,0,0,0
1985647,22,18,1991,1,female,166,54,40,0,0,0,0,0,0
1043365,24,15,1989,5,male,910,54,14,0,1,0,0,0,1
2125571,23,1,1990,5,female,719,55,22,0,0,0,0,0,0
1211611,23,1,1990,9,male,1135,55,23,0,7,0,2,0,5
1809047,23,1,1990,12,male,1168,54,21,0,0,0,0,0,0
1763517,23,29,1990,4,female,1010,55,33,0,2,0,2,0,0
1377279,23,6,1990,11,male,1943,55,24,0,7,0,5,0,2
2059997,23,27,1990,3,male,1819,54,16,0,0,0,0,0,0
2122090,25,12,1988,2,female,642,55,35,0,0,0,0,0,0
1526222,25,25,1988,4,male,1093,54,25,0,0,0,0,0,0
1601215,24,22,1989,3,male,1566,54,37,0,0,0,0,0,0
1943522,24,25,1989,4,female,555,55,5,0,0,0,0,0,0
2079889,26,1,1987,5,female,1349,54,29,0,0,0,0,0,0
1137976,25,22,1988,5,male,28,55,54,0,5,0,3,0,2
1211484,25,1,1988,5,female,389,55,22,0,1,0,1,0,0
2154139,25,1,1988,1,male,1589,55,40,0,0,0,0,0,0
2159790,25,7,1988,6,male,168,55,47,1,0,0,0,1,0
1649846,25,2,1988,3,female,189,54,48,1,0,0,0,1,0
1640311,25,7,1988,6,female,549,55,13,1,0,0,0,1,0
1675274,27,8,1986,8,male,2168,55,23,1,0,0,0,1,0
1692310,26,1,1987,3,male,404,54,42,1,1,0,0,1,1
1363677,26,18,1987,5,male,556,55,51,1,1,0,1,1,0
1828711,26,26,1987,3,male,1450,54,30,1,1,0,0,1,1
1529073,26,21,1987,6,male,137,54,48,1,8,0,2,1,6
1647560,28,12,1985,7,male,188,54,37,1,9,0,8,1,1
1329750,27,6,1986,1,male,293,55,19,1,10,0,8,1,2
1663101,29,4,1984,5,male,166,54,23,1,7,0,0,1,7
1701344,28,5,1985,10,female,542,55,28,1,2,0,2,1,0
1878829,28,3,1985,8,female,377,55,47,1,41,0,4,1,37
1843922,28,10,1985,10,female,367,54,30,1,2,0,0,1,2
1729054,28,8,1985,9,female,445,54,39,1,2,0,0,1,2
1106176,30,15,1983,10,male,426,54,26,1,2,0,0,1,2
1163315,29,22,1984,7,male,206,55,47,1,0,1,0,0,0
1573208,29,22,1984,11,female,336,54,27,1,0,1,0,0,0
1518116,29,1,1984,2,female,599,55,10,1,0,1,0,0,0
1621385,31,25,1982,11,male,607,55,49,1,0,1,0,0,0
1976691,33,10,1980,8,male,510,54,20,1,0,1,0,0,0
1295243,35,7,1978,7,male,193,54,39,1,0,1,0,0,0
1736801,35,28,1978,10,male,402,55,47,1,0,1,0,0,0
1534218,34,24,1979,10,male,232,54,49,1,0,1,0,0,0
1129690,34,22,1979,6,male,630,55,26,1,0,1,0,0,0
1631664,35,24,1978,11,male,152,55,33,1,1,1,1,0,0
1513784,35,21,1978,4,male,386,55,39,1,1,1,1,0,0
1146911,35,5,1978,6,female,530,54,45,1,1,1,0,0,1
1874019,35,5,1978,11,female,268,54,17,1,1,1,1,0,0
1931327,35,5,1978,12,male,65,55,44,1,1,1,1,0,0
1888149,35,6,1978,8,male,155,55,50,1,1,1,1,0,0
1965791,37,24,1976,1,male,324,54,47,1,13,1,10,0,3
1205825,36,5,1977,6,male,124,55,34,1,2,1,2,0,0
1093827,36,9,1977,8,male,140,55,27,1,3,1,3,0,0
1047538,38,27,1975,2,female,274,54,29,1,2,1,2,0,0
2101448,37,24,1976,3,male,601,54,49,1,7,1,6,0,1
1516139,38,15,1975,2,male,223,55,44,1,23,1,10,0,13
1118010,40,10,1973,10,male,135,54,29,1,2,1,0,0,2
1091683,39,1,1974,12,female,591,55,35,1,2,1,2,0,0
1522750,41,7,1972,11,male,306,54,27,1,2,1,1,0,1
2075889,42,24,1971,11,male,105,54,42,1,6,1,1,0,5
1701878,42,13,1971,11,male,272,54,31,1,3,1,3,0,0
1478750,42,27,1971,12,male,1529,55,33,1,21,1,17,0,4
1463165,42,12,1971,2,female,472,55,12,1,7,1,7,0,0
2011805,44,22,1969,5,male,417,55,47,1,15,1,11,0,4
1215359,43,8,1970,5,male,437,54,11,1,2,1,1,0,1
1254890,43,15,1970,1,male,294,54,54,2,0,0,0,2,0
1158918,43,1,1970,2,male,224,55,46,2,0,0,0,2,0
2081445,45,30,1968,2,male,746,54,20,2,0,0,0,2,0
1880975,44,1,1969,12,female,634,55,36,2,1,0,0,2,1
1027065,44,5,1969,5,female,428,55,46,2,1,0,0,2,1
1553778,46,1,1967,11,male,2,55,49,2,2,0,0,2,2
1223518,48,31,1965,11,male,268,54,48,2,3,0,0,2,3
1703367,49,10,1964,4,male,176,55,25,2,3,0,1,2,2
2068922,48,18,1965,12,male,181,55,39,2,3,0,2,2,1
2162982,49,9,1964,5,male,257,55,45,2,5,0,5,2,0
1639983,50,30,1963,6,male,1375,54,30,2,45,0,7,2,38
2122017,50,4,1963,11,male,391,55,29,2,8,1,3,1,5
1139711,51,8,1962,8,male,122,54,46,2,3,1,1,1,2
2081193,52,24,1961,6,female,378,55,39,2,0,2,0,0,0
1703563,52,18,1961,7,male,488,54,23,2,0,2,0,0,0
1457216,52,8,1961,5,male,143,54,40,2,0,2,0,0,0
2067058,55,19,1958,1,male,388,55,43,2,0,2,0,0,0
2155364,56,22,1957,7,male,310,55,37,2,0,2,0,0,0
1141099,57,27,1956,4,female,330,54,26,2,0,2,0,0,0
1763813,57,28,1956,4,male,112,54,27,2,0,2,0,0,0
2018246,57,10,1956,1,male,579,54,19,2,0,2,0,0,0
1034418,59,11,1954,1,female,187,55,32,2,0,2,0,0,0
1432379,58,25,1955,8,male,973,54,35,2,0,2,0,0,0
1443265,61,13,1952,12,female,374,54,34,2,0,2,0,0,0
1422548,61,29,1952,5,male,310,54,42,2,0,2,0,0,0
1428081,61,25,1952,4,female,128,54,46,2,0,2,0,0,0
2103491,63,23,1950,9,male,280,54,35,2,1,2,1,0,0
1462216,63,9,1950,7,male,675,54,33,2,1,2,0,0,1
1093253,63,24,1950,2,male,49,55,36,2,1,2,1,0,0
1479758,66,6,1947,7,male,448,55,41,2,1,2,1,0,0
1141875,67,31,1946,12,male,429,55,37,2,1,2,1,0,0
1636555,67,15,1946,8,male,30,54,43,2,1,2,0,0,1
1467338,67,1,1946,5,male,441,54,45,2,1,2,1,0,0
1748356,68,29,1945,10,male,393,55,45,2,1,2,1,0,0
2129064,68,23,1945,9,male,387,55,32,2,2,2,2,0,0
1228171,68,10,1945,9,male,253,54,28,2,2,2,1,0,1
2177718,71,18,1942,7,male,132,54,46,2,2,2,2,0,0
1072508,73,6,1940,8,male,288,54,39,2,4,2,3,0,1
2159248,72,27,1941,1,male,167,55,45,2,6,2,5,0,1
2167685,76,26,1937,11,male,139,55,45,2,6,2,2,0,4
1781641,78,20,1935,5,male,52,54,25,2,3,2,3,0,0
1897995,81,2,1932,10,male,97,54,44,2,4,2,2,0,2
2180019,81,17,1932,6,female,234,55,20,2,4,2,4,0,0
1693118,82,15,1931,1,female,31,54,45,2,32,2,30,0,2
2096423,84,22,1929,7,male,660,55,21,2,3,2,2,0,1
1340806,85,30,1928,1,male,112,55,26,2,3,2,3,0,0
1311389,85,31,1928,6,male,728,54,25,2,3,2,3,0,0
1389673,89,17,1924,10,male,191,55,41,2,3,2,3,0,0
1894332,103,1,1910,2,male,1681,54,12,2,10,2,9,0,1
1267102,14,30,1999,4,male,1338,55,14,2,3,2,1,0,2
1961895,31,3,1982,1,male,482,55,16,2,5,2,5,0,0
1828845,46,10,1967,10,female,1143,54,23,2,4,2,0,0,4
1962534,93,14,1920,4,male,911,55,24,2,6,2,3,0,3
1599689,21,15,1992,5,male,259,55,42,3,0,0,0,3,0
1545277,58,26,1955,5,female,181,54,30,3,0,0,0,3,0
1070951,69,30,1944,11,female,499,55,51,3,0,0,0,3,0
1237746,19,20,1994,1,male,859,54,45,3,0,0,0,3,0
1145546,23,7,1990,11,male,690,55,36,3,0,0,0,3,0
1566048,24,1,1989,11,male,101,54,46,3,3,0,3,3,0
1683151,24,8,1989,9,male,457,55,28,3,4,0,3,3,1
1563380,30,14,1983,10,male,335,54,45,3,2,0,1,3,1
1769214,53,16,1960,12,male,268,54,48,3,4,0,1,3,3
1104305,62,8,1951,6,male,209,54,30,3,4,0,3,3,1
1079022,65,14,1948,6,female,83,54,49,3,2,0,0,3,2
1769962,66,26,1947,12,female,436,54,30,3,11,0,1,3,10
1388597,18,27,1995,11,male,118,55,47,3,14,0,10,3,4
1442535,24,29,1989,6,female,238,54,30,3,19,0,10,3,9
1106283,23,15,1990,6,female,54,54,44,3,24,0,4,3,20
1076518,25,27,1988,11,female,205,54,45,3,7,0,1,3,6
1326312,24,31,1989,1,female,308,55,37,3,43,2,21,1,22
1069208,27,17,1986,1,male,758,54,35,3,14,1,2,2,12
1158794,27,23,1986,1,male,83,55,50,3,10,2,3,1,7
1226663,45,28,1968,1,male,203,55,44,3,17,1,6,2,11
1246650,53,21,1960,6,male,145,54,19,3,0,3,0,0,0
2034097,17,19,1996,11,male,375,54,23,3,0,3,0,0,0
1565401,17,18,1996,2,male,396,54,52,3,0,3,0,0,0
1251726,22,15,1991,5,female,1723,55,5,3,0,3,0,0,0
1205646,24,2,1989,1,female,212,54,40,3,1,3,1,0,0
1539975,26,5,1987,9,male,406,55,45,3,1,3,1,0,0
2090682,43,16,1970,7,male,443,54,33,3,1,3,1,0,0
1554066,15,10,1998,2,male,1272,54,20,3,1,3,1,0,0
2020996,18,11,1995,1,male,135,55,20,3,4,3,4,0,0
1626247,19,11,1994,8,female,286,55,23,3,4,3,4,0,0
1746180,23,28,1990,9,male,429,55,12,3,2,3,0,0,2
2164338,25,20,1988,8,male,1720,54,26,3,4,3,0,0,4
1612337,27,15,1986,1,female,164,55,31,3,13,3,0,0,13
2044208,36,24,1977,4,male,234,55,43,3,8,3,8,0,0
1018353,38,2,1975,11,male,128,54,24,3,26,3,18,0,8
2023259,39,11,1974,5,male,373,55,39,3,11,3,9,0,2
2020208,43,19,1970,6,male,272,55,53,3,5,3,4,0,1
1464735,48,16,1965,1,male,323,54,31,3,43,3,37,0,6
2193056,53,14,1960,4,male,309,54,36,3,5,3,1,0,4
1273550,54,14,1959,10,male,643,54,19,3,23,3,3,0,20
1707134,58,10,1955,7,male,461,54,25,3,125,3,43,0,82
1363841,59,16,1954,9,female,298,55,34,3,14,3,14,0,0
1414141,25,1,1988,9,female,913,54,21,3,12,3,6,0,6
1357593,36,7,1977,12,female,266,54,32,3,8,3,7,0,1
1543364,51,18,1962,5,female,229,54,33,4,0,0,0,4,0
1949633,43,31,1970,8,male,146,55,54,4,1,0,0,4,1
1400809,62,7,1951,8,male,58,54,31,4,2,0,1,4,1
2127664,35,18,1978,10,female,296,54,32,4,2,0,1,4,1
1336243,19,3,1994,6,female,1355,54,34,4,2,0,2,4,0
1590738,22,10,1991,11,male,1714,55,31,4,5,0,4,4,1
1866376,47,1,1966,10,female,667,54,33,4,15,0,3,4,12
1272869,48,25,1965,6,female,1137,55,14,4,29,0,7,4,22
1872254,72,3,1941,3,female,331,55,46,4,2,1,2,3,0
1157436,32,12,1981,8,female,104,55,33,4,27,2,11,2,16
2036824,32,6,1981,10,male,540,54,50,4,19,2,15,2,4
1740636,16,7,1997,2,female,914,55,47,4,10,1,0,3,10
1646020,17,27,1996,4,male,204,54,42,4,0,4,0,0,0
1901822,20,16,1993,8,male,330,55,33,4,0,4,0,0,0
1531093,21,19,1992,4,male,325,55,37,4,1,4,1,0,0
1717026,21,28,1992,5,male,300,54,46,4,1,4,0,0,1
1843785,22,13,1991,6,male,235,55,37,4,1,4,1,0,0
1358452,28,8,1985,3,female,1054,55,36,4,2,4,2,0,0
1596148,30,17,1983,3,male,217,55,28,4,3,4,3,0,0
1614736,32,23,1981,2,male,204,55,41,4,11,4,10,0,1
2155279,35,3,1978,5,female,59,55,26,4,31,4,28,0,3
2026691,45,11,1968,11,male,360,55,39,4,16,4,10,0,6
1180123,53,22,1960,4,female,493,55,49,4,16,4,7,0,9
1727124,77,5,1936,9,female,577,55,24,4,12,4,4,0,8
1668281,14,15,1999,9,male,203,54,35,5,0,0,0,5,0
1115043,22,27,1991,11,female,187,55,28,5,3,0,0,5,3
1026311,23,27,1990,12,male,569,55,11,5,2,0,2,5,0
1744968,23,7,1990,9,male,88,55,44,5,1,0,0,5,1
1041599,26,1,1987,3,female,1512,55,8,5,1,0,1,5,0
1637727,35,10,1978,8,female,144,54,25,5,3,2,2,3,1
1728039,51,27,1962,4,male,242,54,29,5,6,3,5,2,1
1440660,55,25,1958,10,female,193,54,47,5,6,1,3,4,3
1994904,17,20,1996,4,male,192,54,50,5,9,1,6,4,3
1068916,19,14,1994,1,female,420,54,31,5,0,5,0,0,0
1549960,29,8,1984,7,male,321,54,49,5,0,5,0,0,0
1112401,14,3,1999,3,male,297,54,29,5,0,5,0,0,0
1835804,15,19,1998,3,male,2097,55,11,5,0,5,0,0,0
1072273,17,10,1996,8,male,347,54,36,5,2,5,2,0,0
1475989,17,12,1996,7,male,224,55,45,5,2,5,1,0,1
1124602,18,6,1995,1,male,129,55,45,5,3,5,2,0,1
2010019,22,6,1991,1,male,448,55,2,5,3,5,1,0,2
2125429,25,1,1988,1,male,900,55,25,5,1,5,0,0,1
1928379,25,21,1988,1,male,671,54,23,5,10,5,9,0,1
1710123,30,1,1983,5,male,528,55,48,5,18,5,10,0,8
1552249,37,6,1976,12,female,1490,55,22,5,13,5,8,0,5
1163715,40,25,1973,7,male,156,54,18,5,23,5,12,0,11
1774141,49,2,1964,8,male,327,54,21,6,0,0,0,6,0
1105008,54,13,1959,4,male,621,55,43,6,1,0,0,6,1
1018325,57,25,1956,6,female,86,54,41,6,3,0,0,6,3
1545729,71,6,1942,10,female,1521,54,19,6,7,0,1,6,6
1926163,100,30,1913,10,male,363,54,35,6,9,0,0,6,9
1053687,16,31,1997,8,male,345,55,48,6,3,5,1,1,2
1526514,17,6,1996,7,male,805,54,10,6,0,6,0,0,0
1646043,20,26,1993,8,female,278,54,31,6,0,6,0,0,0
1248993,25,1,1988,2,male,115,55,34,6,0,6,0,0,0
1886660,49,14,1964,8,male,200,55,44,6,1,6,1,0,0
1544765,17,12,1996,11,male,116,54,44,6,7,6,7,0,0
1863488,16,11,1997,6,male,56,55,46,6,11,6,10,0,1
1090119,22,22,1991,5,male,460,54,21,6,14,6,10,0,4
1533593,33,17,1980,9,female,96,55,49,6,23,6,23,0,0
1361234,39,24,1974,3,male,142,54,49,7,1,0,0,7,1
1065236,59,13,1954,8,male,392,55,51,7,0,0,0,7,0
1352369,23,12,1990,7,male,1617,55,17,7,0,0,0,7,0
1903816,24,8,1989,12,female,605,54,6,7,4,1,4,6,0
1064405,59,5,1954,6,male,275,55,45,7,5,0,4,7,1
2143503,61,9,1952,6,male,523,54,34,7,0,4,0,3,0
1195161,77,19,1936,11,female,150,55,32,7,0,5,0,2,0
2083187,16,13,1997,11,male,1538,55,13,7,8,5,4,2,4
1561499,20,16,1993,4,male,250,55,40,7,11,2,4,5,7
1213808,57,1,1956,1,male,810,54,45,7,0,6,0,1,0
1281204,92,20,1921,3,female,1737,54,22,7,0,6,0,1,0
1307425,15,12,1998,2,male,499,54,19,7,0,7,0,0,0
2150030,25,25,1988,1,male,54,55,33,7,2,7,1,0,1
1379418,28,2,1985,6,male,359,54,39,7,3,7,3,0,0
1442807,109,4,1904,3,male,252,55,34,7,2,7,2,0,0
1580751,26,1,1987,10,male,92,55,20,7,4,7,1,0,3
1329826,33,11,1980,3,female,1752,55,21,7,4,7,1,0,3
2165068,36,31,1977,7,female,1542,54,20,7,2,7,1,0,1
1884100,109,29,1904,6,male,36,54,44,7,10,7,7,0,3
1435704,13,14,2000,8,female,462,54,48,7,9,7,4,0,5
1093585,19,17,1994,7,male,51,54,44,7,10,7,9,0,1
2031242,22,6,1991,4,female,508,54,27,7,35,7,18,0,17
1782144,55,7,1958,11,male,1859,54,12,7,17,7,10,0,7
1028308,17,1,1996,12,female,1648,55,21,8,20,0,4,8,16
1389330,20,23,1993,5,female,719,54,30,8,1,4,0,4,1
2156861,25,3,1988,1,male,533,54,48,8,2,7,1,1,1
1062979,24,22,1989,5,male,18,55,52,8,7,7,2,1,5
1831031,27,24,1986,10,male,318,54,45,8,5,6,2,2,3
1935961,28,4,1985,9,female,348,54,20,8,22,7,1,1,21
1054999,31,16,1982,2,male,58,55,50,8,0,8,0,0,0
1453651,33,27,1980,2,male,402,55,44,8,0,8,0,0,0
1798139,41,3,1972,8,male,1638,55,33,8,0,8,0,0,0
1980034,45,12,1968,12,female,265,55,37,8,2,8,1,0,1
1155525,65,26,1948,6,female,208,55,38,8,7,8,7,0,0
1675400,93,8,1920,11,male,1053,55,24,8,27,8,19,0,8
1106268,60,2,1953,11,female,724,55,35,8,13,8,9,0,4
2064879,22,9,1991,1,female,829,55,26,9,9,0,2,9,7
1140781,30,19,1983,10,male,415,55,13,9,7,0,0,9,7
1146372,68,4,1945,9,female,574,54,21,9,6,0,2,9,4
1301824,77,7,1936,7,male,158,54,26,9,13,0,5,9,8
1935815,44,2,1969,7,male,393,54,38,9,21,0,11,9,10
1113789,58,2,1955,9,male,415,55,12,9,99,0,66,9,33
1999233,70,26,1943,7,male,47,55,52,9,0,7,0,2,0
1573151,66,3,1947,11,male,1742,55,35,9,1,7,0,2,1
1325570,22,13,1991,12,female,724,55,49,9,2,8,2,1,0
1872248,67,14,1946,12,female,574,54,28,9,2,9,2,0,0
1801265,70,5,1943,6,female,278,55,39,9,5,9,5,0,0
1648622,25,20,1988,4,female,1682,54,22,9,6,9,3,0,3
1493767,44,28,1969,1,female,114,55,39,9,7,9,5,0,2
1236006,18,4,1995,9,male,385,55,36,10,11,0,4,10,7
1776016,28,5,1985,7,female,422,54,45,10,24,0,4,10,20
1749401,28,4,1985,10,male,235,55,41,10,30,5,22,5,8
1799564,53,29,1960,6,male,1116,54,50,10,1,10,1,0,0
2060546,23,21,1990,7,male,521,54,24,10,0,10,0,0,0
1526239,20,20,1993,11,male,598,55,37,10,1,10,1,0,0
1794745,23,17,1990,5,female,453,55,34,10,2,10,1,0,1
1453033,32,27,1981,8,male,596,54,33,10,4,10,4,0,0
1606374,51,27,1962,5,male,1173,55,21,10,5,10,3,0,2
1671629,51,7,1962,11,male,121,55,44,10,13,10,13,0,0
1684695,46,30,1967,8,male,503,55,37,10,8,10,5,0,3
1930856,23,19,1990,1,male,208,55,32,10,10,10,10,0,0
1999495,23,10,1990,12,male,18,55,53,10,14,10,10,0,4
1129864,47,27,1966,10,female,609,55,28,10,10,10,8,0,2
1067921,82,14,1931,10,female,175,54,28,10,31,10,30,0,1
1370405,48,5,1965,10,male,314,55,29,11,3,0,2,11,1
1169731,42,15,1971,11,female,361,55,26,11,15,0,2,11,13
1553325,108,2,1905,8,female,400,54,13,11,22,6,14,5,8
1411777,23,15,1990,8,female,1345,54,23,11,22,10,13,1,9
1389762,16,27,1997,7,male,409,55,49,11,1,11,1,0,0
1163882,27,30,1986,12,male,52,55,23,11,0,11,0,0,0
1496143,41,25,1972,1,male,2244,55,17,11,1,11,1,0,0
1827107,56,13,1957,8,male,1111,55,34,11,0,11,0,0,0
1507887,19,30,1994,11,male,200,54,26,11,7,11,4,0,3
2045795,21,20,1992,12,male,186,55,34,11,16,11,15,0,1
1275072,22,1,1991,5,female,592,55,31,11,14,11,9,0,5
1397432,31,27,1982,9,male,1792,54,26,11,9,11,8,0,1
1958254,60,13,1953,9,female,132,54,29,11,35,11,22,0,13
1723702,19,1,1994,4,female,374,55,36,12,3,0,0,12,3
1137016,37,5,1976,1,female,727,54,34,12,17,0,4,12,13
1916412,60,14,1953,8,male,183,55,36,12,8,6,5,6,3
1290398,63,9,1950,6,female,377,54,16,12,39,5,29,7,10
1044498,53,24,1960,1,male,500,54,31,12,24,10,19,2,5
1134658,22,30,1991,10,male,1466,54,14,12,48,10,29,2,19
1728767,24,18,1989,1,male,668,55,48,12,0,12,0,0,0
1145873,62,18,1951,6,female,102,55,39,12,4,12,4,0,0
1954648,27,1,1986,6,male,167,54,40,12,7,12,5,0,2
1114011,42,24,1971,12,female,1725,55,24,12,5,12,2,0,3
1863717,39,21,1974,9,female,281,54,45,12,19,12,3,0,16
1547140,39,26,1974,4,male,412,54,41,12,28,12,12,0,16
1711963,55,21,1958,8,male,20,54,50,13,13,1,11,12,2
1857733,26,17,1987,2,male,885,54,20,13,36,0,35,13,1
1567196,33,11,1980,1,male,84,54,32,13,10,3,5,10,5
1617559,20,16,1993,3,male,101,55,50,13,24,9,24,4,0
2134088,29,23,1984,4,female,218,54,41,13,2,13,2,0,0
1105998,30,19,1983,12,male,794,54,38,13,1,13,0,0,1
1757610,18,11,1995,1,female,98,54,40,13,19,13,12,0,7
1132833,23,14,1990,8,female,81,54,34,13,30,13,23,0,7
2147687,53,17,1960,1,male,75,55,50,14,2,0,1,14,1
1753253,51,4,1962,5,female,476,54,28,14,23,0,2,14,21
1175971,42,21,1971,1,male,1102,54,29,14,4,4,1,10,3
1611630,23,25,1990,5,male,511,54,28,14,11,3,7,11,4
2135612,35,17,1978,4,male,274,55,30,14,1,13,1,1,0
1599914,67,1,1946,11,male,323,55,33,14,3,14,1,0,2
1682125,38,19,1975,5,female,294,55,38,14,3,14,3,0,0
1836308,19,1,1994,5,male,25,54,40,14,6,14,6,0,0
1474608,68,20,1945,8,male,541,54,28,14,18,14,9,0,9
1691896,33,27,1980,8,male,758,54,34,14,25,14,22,0,3
1253698,13,5,2000,5,male,650,54,9,14,32,14,22,0,10
1528138,19,29,1994,1,male,931,54,32,14,41,14,21,0,20
2152401,26,30,1987,9,male,265,54,42,15,1,0,0,15,1
1711091,33,28,1980,1,female,489,54,38,15,4,0,1,15,3
1160528,53,18,1960,4,female,424,55,35,15,11,2,8,13,3
1509358,61,9,1952,2,female,1616,54,10,15,22,2,9,13,13
1449689,21,22,1992,6,male,573,55,34,15,2,10,2,5,0
1504840,25,17,1988,10,male,1794,55,14,15,68,5,23,10,45
2066401,28,3,1985,2,male,403,54,31,15,55,11,35,4,20
2110034,29,19,1984,4,male,607,55,37,15,2,15,1,0,1
2054668,48,1,1965,11,male,96,54,42,15,15,15,11,0,4
1981571,98,25,1915,4,female,8,55,52,15,17,15,14,0,3
1606947,72,24,1941,8,female,102,55,42,16,59,0,38,16,21
1199618,23,25,1990,1,female,98,54,40,16,23,10,16,6,7
1820290,18,30,1995,3,male,1615,55,41,16,5,14,1,2,4
1903145,64,26,1949,9,male,485,54,36,16,0,16,0,0,0
1006430,22,21,1991,6,male,171,54,46,16,1,16,1,0,0
1425398,18,22,1995,1,male,170,55,38,16,0,16,0,0,0
1252736,28,19,1985,9,male,599,55,33,16,8,16,2,0,6
1318377,64,25,1949,1,female,2107,55,24,16,4,16,3,0,1
1561465,17,31,1996,2,male,27,55,47,16,10,16,6,0,4
1705937,24,20,1989,9,male,49,54,44,16,10,16,9,0,1
1411603,22,11,1991,1,male,315,54,44,16,16,16,8,0,8
1971427,25,22,1988,12,male,864,54,33,17,0,0,0,17,0
1680244,37,3,1976,3,male,266,55,44,17,4,0,0,17,4
1715038,50,25,1963,6,female,518,54,28,17,8,3,3,14,5
1871494,57,19,1956,5,female,1975,54,14,17,22,0,19,17,3
1861841,59,22,1954,9,female,1514,54,29,17,30,6,13,11,17
1344957,60,25,1953,4,male,1167,55,30,17,0,17,0,0,0
1312941,108,21,1905,12,female,988,55,38,17,5,17,5,0,0
1739945,39,4,1974,1,male,252,54,31,17,17,17,8,0,9
1938164,58,29,1955,11,male,671,54,24,17,15,17,4,0,11
1929916,43,31,1970,10,male,525,54,15,17,28,17,22,0,6
1639400,24,8,1989,1,male,716,55,39,18,0,0,0,18,0
1388908,31,10,1982,7,female,211,54,38,18,4,0,1,18,3
1310731,49,30,1964,6,male,405,54,28,18,23,0,4,18,19
1049821,53,9,1960,1,female,132,54,43,18,32,0,9,18,23
1530537,65,8,1948,7,female,602,54,33,18,67,0,38,18,29
1140627,62,21,1951,8,female,390,55,16,18,30,16,22,2,8
1013248,52,1,1961,3,male,433,54,32,18,8,18,8,0,0
1749407,23,15,1990,4,male,383,55,33,18,21,18,7,0,14
1931254,29,27,1984,3,male,285,54,46,19,0,0,0,19,0
1766829,42,12,1971,6,female,571,54,49,19,1,0,0,19,1
1859170,22,12,1991,4,male,179,55,49,19,0,19,0,0,0
1914262,25,16,1988,2,female,308,54,33,19,0,19,0,0,0
1703629,35,23,1978,9,female,224,55,30,19,20,19,20,0,0
1855617,22,15,1991,4,male,186,54,46,19,30,19,18,0,12
2047101,22,2,1991,10,male,202,54,30,19,77,19,13,0,64
1168291,25,28,1988,7,female,370,55,21,19,89,19,79,0,10
1234816,29,21,1984,12,male,666,55,43,19,38,19,32,0,6
1190482,43,7,1970,3,male,317,55,51,20,0,0,0,20,0
2091283,60,25,1953,10,male,330,55,46,20,0,0,0,20,0
1473119,50,1,1963,1,male,262,55,31,20,2,0,1,20,1
1631705,19,18,1994,10,male,1118,55,31,20,12,0,8,20,4
1962276,22,12,1991,3,male,645,55,30,20,15,12,12,8,3
1308613,32,22,1981,12,female,449,55,32,20,30,19,19,1,11
1763242,18,20,1995,3,male,392,55,41,20,1,20,0,0,1
1354592,23,6,1990,5,female,103,54,40,20,5,20,4,0,1
2166807,47,3,1966,12,female,162,54,34,20,24,20,23,0,1
1358815,57,30,1956,8,male,1784,54,15,20,51,20,39,0,12
1291829,17,29,1996,10,female,1609,55,32,21,18,0,2,21,16
1569843,24,7,1989,2,male,279,55,32,21,26,8,10,13,16
1941229,58,10,1955,11,male,592,55,27,21,3,21,3,0,0
1914472,62,17,1951,11,male,752,55,11,21,8,21,5,0,3
1731439,49,15,1964,9,female,233,55,15,21,16,21,16,0,0
1007858,52,30,1961,1,male,193,54,20,21,28,21,18,0,10
1851043,51,6,1962,9,male,772,54,37,21,20,21,13,0,7
1214579,23,10,1990,3,male,328,54,22,21,108,21,82,0,26
1458611,18,7,1995,4,female,291,55,38,22,5,4,3,18,2
2124910,18,1,1995,6,male,116,55,39,22,7,0,3,22,4
1117000,74,16,1939,10,female,660,55,38,22,24,0,6,22,18
1717311,32,1,1981,8,female,1031,54,37,22,2,18,2,4,0
1417926,20,15,1993,7,female,54,55,48,22,72,22,44,0,28
1971773,23,6,1990,12,male,773,54,35,22,59,22,31,0,28
1185966,64,29,1949,10,male,821,54,33,22,40,22,39,0,1
1178602,22,1,1991,6,female,156,54,30,23,7,0,2,23,5
1595081,27,6,1986,10,female,1346,54,14,23,9,0,2,23,7
1421004,97,16,1916,8,male,242,55,38,23,10,5,0,18,10
2189173,108,27,1905,1,female,190,55,33,23,8,23,7,0,1
1411725,48,21,1965,4,male,1297,54,19,23,5,23,4,0,1
1855487,25,28,1988,12,male,394,54,46,23,79,23,66,0,13
2100723,15,4,1998,12,male,612,54,26,23,39,23,25,0,14
1925203,56,4,1957,2,male,373,55,20,23,142,23,134,0,8
1277473,22,30,1991,10,male,1713,55,11,23,42,23,26,0,16
2152844,43,9,1970,12,female,289,54,30,24,3,1,0,23,3
1823867,17,18,1996,1,male,1621,55,40,24,8,0,3,24,5
1686847,69,16,1944,10,female,1734,54,25,24,11,24,7,0,4
2074178,102,10,1911,1,male,474,54,42,24,8,24,8,0,0
2153266,23,17,1990,3,male,71,55,38,24,19,24,16,0,3
1690815,22,3,1991,6,male,173,55,34,24,21,24,12,0,9
1676979,26,10,1987,10,female,255,55,26,24,37,24,25,0,12
1590590,52,5,1961,1,female,567,54,24,25,3,1,3,24,0
2061535,108,1,1905,8,female,662,54,39,25,27,0,9,25,18
1427286,33,5,1980,2,female,1727,55,15,25,3,7,2,18,1
1145751,29,6,1984,1,male,88,55,21,25,46,11,28,14,18
2017975,38,15,1975,5,male,406,54,45,25,0,25,0,0,0
1027125,63,1,1950,1,female,428,55,39,25,3,25,2,0,1
1544930,25,28,1988,3,male,142,54,49,25,7,25,5,0,2
1764372,23,14,1990,11,female,257,55,24,25,9,25,9,0,0
1003156,59,5,1954,6,female,458,55,40,26,20,0,11,26,9
1509168,84,7,1929,6,male,553,55,16,26,58,14,21,12,37
1112485,35,24,1978,7,male,205,55,40,26,2,26,2,0,0
1527103,67,1,1946,6,male,851,55,31,26,1,26,1,0,0
1589678,23,28,1990,12,female,287,55,32,26,39,26,20,0,19
1427927,35,21,1978,3,male,438,55,15,27,2,27,2,0,0
1190855,17,7,1996,1,female,675,54,41,27,2,27,2,0,0
1018330,42,14,1971,5,female,412,54,25,27,8,27,7,0,1
1557359,26,17,1987,11,male,182,55,24,27,5,27,3,0,2
1993744,41,13,1972,12,male,433,55,27,27,11,27,3,0,8
1884331,67,27,1946,2,male,275,55,22,27,10,27,8,0,2
2151278,15,20,1998,2,female,1679,54,30,27,9,27,8,0,1
1964769,30,16,1983,9,female,1360,55,19,27,17,27,11,0,6
1768096,40,26,1973,12,male,457,55,43,28,6,28,6,0,0
1199274,21,8,1992,2,male,239,55,31,29,28,1,4,28,24
2084178,66,24,1947,9,male,917,55,20,29,181,1,51,28,130
1968961,15,15,1998,4,male,644,55,15,29,24,15,14,14,10
1229615,17,30,1996,9,female,489,54,47,29,31,22,14,7,17
1897041,26,1,1987,7,female,915,55,39,29,38,29,22,0,16
2116114,17,3,1996,3,female,523,55,34,29,82,29,44,0,38
1907534,23,3,1990,1,male,156,55,36,30,16,0,0,30,16
1830334,42,19,1971,10,male,306,54,32,31,46,26,41,5,5
1070732,64,13,1949,8,female,486,54,25,31,31,26,16,5,15
1905833,21,4,1992,11,female,458,55,38,31,4,31,4,0,0
1777017,60,16,1953,3,female,340,54,30,31,15,31,1,0,14
1581292,65,10,1948,8,male,1497,55,18,31,7,31,3,0,4
1601807,31,31,1982,3,female,188,55,22,31,8,31,3,0,5
2053241,49,25,1964,6,female,1206,55,34,31,8,31,4,0,4
1856352,35,18,1978,2,female,226,55,31,30,11,30,6,0,5
1469382,41,1,1972,6,female,1382,54,29,30,9,30,9,0,0
1365831,54,3,1959,11,male,303,54,14,30,28,30,19,0,9
2128292,31,27,1982,6,female,477,55,31,32,71,0,10,32,61
1451825,57,21,1956,10,female,506,54,23,32,114,29,49,3,65
1148095,64,26,1949,8,female,1230,54,30,32,11,32,4,0,7
1129172,27,17,1986,7,male,117,54,32,32,55,32,41,0,14
1254503,29,17,1984,8,male,376,55,38,33,9,0,3,33,6
2049606,24,16,1989,9,male,341,55,38,33,13,33,12,0,1
1569416,19,25,1994,1,male,1418,55,41,33,45,33,33,0,12
1855445,60,1,1953,1,male,195,55,8,34,0,33,0,1,0
1141693,21,7,1992,3,male,265,54,37,34,5,34,5,0,0
1964994,23,9,1990,12,female,47,55,33,34,1,34,1,0,0
1044148,31,19,1982,5,female,510,55,20,34,11,34,3,0,8
2086181,15,27,1998,7,male,85,55,42,34,14,34,14,0,0
1150606,23,23,1990,1,male,369,55,46,34,6,34,2,0,4
1740287,33,23,1980,4,male,326,54,41,35,92,0,1,35,91
1421128,38,26,1975,11,male,233,55,38,36,14,24,6,12,8
1118305,19,27,1994,11,male,773,54,14,35,8,23,2,12,6
1653120,19,24,1994,4,male,377,55,34,36,142,23,58,13,84
1659574,31,29,1982,10,female,1159,54,15,36,50,29,45,7,5
1383417,67,12,1946,10,male,703,54,43,36,23,36,20,0,3
1137308,54,17,1959,8,male,1167,54,11,37,14,0,8,37,6
1413672,14,4,1999,12,female,1113,55,43,37,66,0,12,37,54
1007722,20,26,1993,8,female,1959,55,44,37,377,8,193,29,184
2145692,15,23,1998,11,male,481,54,36,37,4,37,2,0,2
1423233,69,19,1944,1,female,1820,55,12,37,27,37,15,0,12
1457841,52,3,1961,7,female,344,54,47,38,5,36,1,2,4
1659481,108,17,1905,5,female,599,54,48,38,0,38,0,0,0
1057545,14,18,1999,8,male,1764,55,12,39,14,39,10,0,4
1997827,31,19,1982,8,female,278,54,36,38,10,38,1,0,9
1201711,26,1,1987,4,male,1385,55,25,38,13,38,11,0,2
1695247,21,15,1992,8,male,579,54,52,39,26,39,26,0,0
1530239,29,1,1984,4,female,270,55,14,38,28,38,19,0,9
1621826,54,27,1959,9,male,474,54,28,40,6,0,4,40,2
1040650,31,27,1982,3,male,1583,54,47,40,173,19,115,21,58
1259948,19,16,1994,11,female,1014,55,29,40,30,37,16,3,14
2041682,42,28,1971,5,female,113,54,36,40,38,39,27,1,11
1602858,69,16,1944,2,female,396,55,23,40,43,37,33,3,10
1994357,68,17,1945,4,female,56,54,35,40,6,40,4,0,2
2138052,33,14,1980,6,male,349,54,52,41,6,0,1,41,5
1397604,35,23,1978,12,female,443,55,38,42,8,0,2,42,6
2012968,49,5,1964,7,female,1851,55,23,41,51,27,16,14,35
1508218,30,21,1983,8,female,1551,54,31,41,0,40,0,1,0
1239905,54,31,1959,10,male,450,54,27,41,74,41,48,0,26
1716634,52,28,1961,1,male,36,54,24,44,3,1,0,43,3
1325579,22,24,1991,5,female,135,55,27,44,16,0,15,44,1
1634940,63,4,1950,2,male,390,54,24,44,42,21,33,23,9
1607854,24,8,1989,11,female,27,54,15,43,7,43,2,0,5
1038896,36,6,1977,8,male,39,55,34,44,0,44,0,0,0
1585096,45,1,1968,5,male,415,55,36,44,19,44,17,0,2
2060234,62,14,1951,12,male,442,54,42,43,51,43,46,0,5
1360138,65,8,1948,3,female,1382,55,35,45,6,0,2,45,4
1279560,98,7,1915,5,female,593,55,49,45,25,0,14,45,11
1841084,64,17,1949,3,female,12,55,45,45,29,0,1,45,28
2020147,67,20,1946,5,male,556,54,21,45,8,45,8,0,0
1317927,29,3,1984,11,female,215,55,23,47,74,7,7,40,67
2006819,36,3,1977,11,female,46,54,38,46,81,2,43,44,38
1684855,20,17,1993,1,male,393,55,24,47,3,47,3,0,0
1988306,50,3,1963,2,female,605,54,42,46,0,46,0,0,0
